date,a__team,h__team,a__goals_p1,a__goals_p2,a__goals_p3,a__goals_ot,a__goals_total,h__goals_p1,h__goals_p2,h__goals_p3,h__goals_ot,h__goals_total,moneyline,fav,over_under
2022-10-11,TB,NYR,0,1,0,0,1,0,1,2,0,3,-130,Home,5.5
2022-10-11,VGK,LA,0,1,3,0,4,1,0,2,0,3,-120,Home,6
2022-10-12,BOS,WAS,2,1,2,0,5,0,2,0,0,2,-160,Home,6
2022-10-12,CBJ,CAR,0,1,0,0,1,0,2,2,0,4,-292,Home,6.5
2022-10-12,TOR,MTL,1,1,1,0,3,0,2,2,0,4,-260,Away,6.5
2022-10-12,CHI,COL,1,0,1,0,2,2,2,1,0,5,-430,Home,6.5
2022-10-12,SEA,ANA,1,2,1,0,4,1,1,2,1,5,-115,Home,5.5
2022-10-12,VAN,EDM,2,1,0,0,3,0,3,2,0,5,-190,Home,6.5
2022-10-13,ARI,PIT,0,1,1,0,2,3,1,2,0,6,-420,Home,6.5
2022-10-13,NJ,PHI,1,0,1,0,2,1,2,2,0,5,-125,Away,6
2022-10-13,OTT,BUF,1,0,0,0,1,0,2,2,0,4,-120,Away,6.5
2022-10-13,FLA,NYI,0,1,2,0,3,0,0,1,0,1,-145,Away,6
2022-10-13,WAS,TOR,2,0,0,0,2,1,1,1,0,3,-220,Home,7
2022-10-13,NYR,MIN,3,1,3,0,7,0,1,2,0,3,-125,Home,6
2022-10-13,DAL,NSH,2,1,1,0,4,0,0,1,0,1,-135,Home,5.5
2022-10-13,COL,CGY,1,0,2,0,3,1,2,2,0,5,-140,Home,6.5
2022-10-13,CHI,VGK,0,0,0,0,0,0,1,0,0,1,-365,Home,6.5
2022-10-13,SEA,LA,1,2,1,0,4,1,0,0,0,1,-178,Home,6
2022-10-14,MTL,DET,0,0,0,0,0,0,0,3,0,3,-165,Home,6.5
2022-10-14,TB,CBJ,3,1,1,0,5,2,0,0,0,2,-210,Away,6
2022-10-14,NYR,WPG,0,0,1,0,1,1,0,3,0,4,-145,Home,6.5
2022-10-14,CAR,SJ,0,1,1,0,2,1,0,0,0,1,-195,Away,6
2022-10-15,FLA,BUF,2,2,0,0,4,2,1,0,0,3,-190,Away,7
2022-10-15,VAN,PHI,2,0,0,0,2,0,2,1,0,3,-170,Away,6
2022-10-15,ARI,BOS,0,1,2,0,3,2,1,3,0,6,-355,Home,6.5
2022-10-15,DET,NJ,0,4,1,0,5,1,1,0,0,2,-178,Home,6.5
2022-10-15,MTL,WAS,0,1,0,0,1,0,3,0,0,3,-305,Home,6.5
2022-10-15,OTT,TOR,1,0,1,0,2,0,1,2,0,3,-250,Home,6.5
2022-10-15,TB,PIT,1,0,1,0,2,1,1,4,0,6,-175,Home,6.5
2022-10-15,ANA,NYI,0,0,1,0,1,2,3,2,0,7,-170,Home,5.5
2022-10-15,CBJ,STL,0,2,0,0,2,1,1,3,0,5,-267,Home,6.5
2022-10-15,LA,MIN,4,2,1,0,7,2,2,2,0,6,-170,Home,6
2022-10-15,NSH,DAL,0,1,0,0,1,1,2,2,0,5,-125,Home,5.5
2022-10-15,CGY,EDM,4,0,0,0,4,1,2,0,0,3,-135,Home,7
2022-10-15,CHI,SJ,0,3,2,0,5,2,0,0,0,2,-140,Home,6
2022-10-15,VGK,SEA,2,3,0,0,5,0,0,2,0,2,-130,Away,6.5
2022-10-17,ANA,NYR,1,1,2,0,4,2,3,1,0,6,-250,Home,6
2022-10-17,ARI,TOR,1,1,2,0,4,0,0,2,0,2,-550,Home,7
2022-10-17,FLA,BOS,0,1,2,0,3,1,1,3,0,5,-135,Away,6.5
2022-10-17,LA,DET,2,1,1,1,5,1,1,2,0,4,-145,Away,6.5
2022-10-17,PIT,MTL,0,2,0,0,2,0,0,2,1,3,-260,Away,7
2022-10-17,VAN,WAS,1,3,0,0,4,1,1,4,0,6,-135,Home,6
2022-10-17,COL,MIN,2,1,3,0,6,1,1,1,0,3,-125,Away,6.5
2022-10-17,WPG,DAL,1,0,0,0,1,1,2,1,0,4,-145,Home,6
2022-10-17,CAR,SEA,1,3,1,0,5,0,1,0,0,1,-170,Away,6.5
2022-10-18,ANA,NJ,2,0,0,0,2,0,2,2,0,4,-195,Home,6.5
2022-10-18,BOS,OTT,1,4,0,0,5,3,3,1,0,7,-130,Home,6
2022-10-18,PHI,TB,0,1,2,0,3,0,2,0,0,2,-320,Home,6
2022-10-18,VAN,CBJ,2,0,1,0,3,0,1,2,1,4,-115,Away,6
2022-10-18,SJ,NYI,1,1,0,0,2,0,3,2,0,5,-195,Home,5.5
2022-10-18,BUF,EDM,1,2,1,0,4,1,0,1,0,2,-235,Home,7
2022-10-18,VGK,CGY,2,0,0,0,2,0,2,1,0,3,-165,Home,6.5
2022-10-18,LA,NSH,0,1,2,1,4,1,2,0,0,3,-178,Home,6
2022-10-19,PHI,FLA,1,1,1,0,3,2,0,2,0,4,-365,Home,6.5
2022-10-19,WPG,COL,2,1,0,1,4,0,3,0,0,3,-240,Home,6.5
2022-10-19,STL,SEA,3,0,0,1,4,1,2,0,0,3,-140,Away,6
2022-10-20,ANA,BOS,0,1,0,0,1,0,1,0,1,2,-220,Home,6.5
2022-10-20,ARI,MTL,0,0,2,0,2,3,2,1,0,6,-178,Home,6.5
2022-10-20,DAL,TOR,1,0,1,0,2,0,1,1,1,3,-190,Home,6.5
2022-10-20,LA,PIT,0,0,1,0,1,3,1,2,0,6,-195,Home,6.5
2022-10-20,NSH,CBJ,2,1,0,0,3,0,1,4,0,5,-155,Away,6.5
2022-10-20,SJ,NYR,1,1,0,1,3,0,2,0,0,2,-292,Home,6.5
2022-10-20,WAS,OTT,2,0,0,0,2,0,2,3,0,5,0,Even,6.5
2022-10-20,NJ,NYI,0,2,2,0,4,0,0,1,0,1,-155,Home,6.5
2022-10-20,VAN,MIN,2,1,0,0,3,2,0,1,1,4,-180,Home,6.5
2022-10-20,CAR,EDM,0,2,2,0,4,1,2,3,0,6,-115,Home,6.5
2022-10-20,BUF,CGY,3,1,2,0,6,1,1,1,0,3,-292,Home,6.5
2022-10-20,WPG,VGK,0,1,1,0,2,4,0,1,0,5,-240,Home,7
2022-10-21,TB,FLA,1,0,1,1,3,1,1,0,0,2,-115,Home,6.5
2022-10-21,DET,CHI,2,1,0,0,3,0,1,2,1,4,-120,Away,6.5
2022-10-21,SEA,COL,0,2,1,0,3,0,1,1,0,2,-240,Home,6.5
2022-10-22,MIN,BOS,1,1,1,0,3,2,1,0,1,4,0,Even,6.5
2022-10-22,SJ,NJ,0,1,0,0,1,0,2,0,0,2,-210,Home,6.5
2022-10-22,ARI,OTT,0,2,0,0,2,2,1,3,0,6,-250,Home,6.5
2022-10-22,STL,EDM,1,0,1,0,2,0,0,0,0,0,-160,Home,7
2022-10-22,DAL,MTL,1,3,1,0,5,1,1,0,0,2,-178,Away,6
2022-10-22,LA,WAS,0,2,1,0,3,0,0,4,0,4,-135,Home,6.5
2022-10-22,NYI,TB,1,1,1,0,3,2,2,1,0,5,-130,Home,6
2022-10-22,PIT,CBJ,0,3,3,0,6,2,1,0,0,3,-155,Away,6.5
2022-10-22,TOR,WPG,1,2,1,0,4,1,0,0,0,1,-165,Away,6.5
2022-10-22,PHI,NSH,2,0,1,0,3,0,0,1,0,1,-225,Home,6.5
2022-10-22,BUF,VAN,2,0,3,0,5,0,1,0,0,1,-160,Home,6.5
2022-10-22,CAR,CGY,2,0,0,0,2,1,1,0,1,3,-155,Home,6
2022-10-22,COL,VGK,1,1,1,0,3,1,0,1,0,2,-130,Home,6.5
2022-10-23,SEA,CHI,2,2,0,0,4,2,1,2,0,5,-135,Away,6
2022-10-23,ANA,DET,1,0,0,0,1,2,1,2,0,5,-135,Home,6.5
2022-10-23,CBJ,NYR,1,2,2,0,5,0,1,0,0,1,-305,Home,6.5
2022-10-23,NYI,FLA,0,1,1,0,2,2,0,1,0,3,-205,Home,6.5
2022-10-23,SJ,PHI,0,2,1,0,3,0,0,0,0,0,-125,Home,6
2022-10-24,DAL,OTT,1,0,1,0,2,0,1,3,0,4,-120,Home,6.5
2022-10-24,WAS,NJ,1,4,1,0,6,1,0,2,0,3,-130,Home,6.5
2022-10-24,PIT,EDM,2,1,0,0,3,1,4,1,0,6,-125,Home,6.5
2022-10-24,STL,WPG,0,0,0,0,0,0,1,3,0,4,-125,Home,6
2022-10-24,TOR,VGK,0,1,0,0,1,1,0,2,0,3,0,Even,6.5
2022-10-24,CAR,VAN,1,0,2,0,3,1,0,1,0,2,-165,Away,6.5
2022-10-25,ARI,CBJ,2,2,2,0,6,0,0,3,0,3,-225,Home,6.5
2022-10-25,DAL,BOS,0,1,0,0,1,1,1,1,0,3,-178,Home,6
2022-10-25,MIN,MTL,1,1,1,0,3,0,1,0,0,1,-210,Away,6.5
2022-10-25,NJ,DET,2,2,2,0,6,1,0,1,0,2,-115,Home,6.5
2022-10-25,COL,NYR,1,0,1,1,3,0,1,1,0,2,0,Even,6
2022-10-25,FLA,CHI,0,0,2,0,2,2,1,1,0,4,-250,Away,6.5
2022-10-25,PIT,CGY,0,1,0,0,1,2,2,0,0,4,-205,Home,6.5
2022-10-25,BUF,SEA,0,1,0,0,1,2,2,1,0,5,-140,Home,6.5
2022-10-25,VGK,SJ,1,0,3,0,4,0,2,0,0,2,-165,Away,6.5
2022-10-25,TB,LA,1,0,1,0,2,1,2,1,0,4,-140,Away,6.5
2022-10-26,NYR,NYI,0,0,0,0,0,0,1,2,0,3,-150,Home,6
2022-10-26,EDM,STL,1,0,2,0,3,0,1,0,0,1,-120,Away,6.5
2022-10-26,TB,ANA,2,0,2,0,4,1,1,0,0,2,-145,Away,6.5
2022-10-27,DET,BOS,0,1,0,0,1,1,1,3,0,5,-260,Home,6.5
2022-10-27,FLA,PHI,2,0,1,0,3,2,2,0,0,4,-210,Away,6.5
2022-10-27,MIN,OTT,2,1,1,0,4,1,0,1,0,2,-125,Away,6.5
2022-10-27,MTL,BUF,1,0,2,0,3,0,1,1,0,2,-195,Home,6.5
2022-10-27,STL,NSH,1,1,0,0,2,1,2,3,0,6,-178,Home,6
2022-10-27,EDM,CHI,1,2,3,0,6,2,2,1,0,5,-210,Away,6.5
2022-10-27,WAS,DAL,0,0,0,0,0,1,0,1,0,2,-125,Home,6
2022-10-27,VAN,SEA,1,2,2,0,5,2,1,1,0,4,-125,Home,6.5
2022-10-27,TOR,SJ,1,1,1,0,3,1,2,0,1,4,-225,Away,6.5
2022-10-27,WPG,LA,2,2,2,0,6,3,0,1,0,4,-145,Home,6
2022-10-28,ANA,VGK,0,0,0,0,0,1,3,0,0,4,-292,Home,6.5
2022-10-28,BOS,CBJ,1,3,0,0,4,0,0,0,0,0,-140,Away,6.5
2022-10-28,COL,NJ,0,0,0,0,0,0,0,1,0,1,-125,Away,6.5
2022-10-28,NYI,CAR,1,2,3,0,6,0,2,0,0,2,-195,Home,6
2022-10-28,PIT,VAN,0,1,0,0,1,1,1,3,0,5,-205,Away,6.5
2022-10-28,WPG,ARI,1,0,1,1,3,2,0,0,0,2,-155,Away,6.5
2022-10-29,NYR,DAL,1,2,3,0,6,1,2,0,0,3,-115,Away,5.5
2022-10-29,OTT,FLA,0,2,1,0,3,2,1,2,0,5,-205,Home,6.5
2022-10-29,TB,SJ,2,1,1,0,4,1,1,1,0,3,-205,Away,6
2022-10-29,CAR,PHI,2,0,1,1,4,0,2,1,0,3,-190,Away,6
2022-10-29,CHI,BUF,1,2,0,0,3,1,0,2,1,4,-178,Home,6.5
2022-10-29,MIN,DET,1,0,0,0,1,1,1,0,0,2,-160,Away,6.5
2022-10-29,MTL,STL,1,3,3,0,7,1,2,1,0,4,-250,Home,6
2022-10-29,TOR,LA,1,1,0,0,2,0,3,1,0,4,-145,Away,6.5
2022-10-29,COL,NYI,0,3,1,0,4,0,1,4,0,5,-135,Away,6
2022-10-29,WAS,NSH,0,1,2,0,3,0,0,0,0,0,-130,Home,6
2022-10-29,EDM,CGY,0,1,2,0,3,0,2,0,0,2,-155,Home,6.5
2022-10-29,PIT,SEA,0,1,0,0,1,0,2,1,0,3,-130,Away,6.5
2022-10-30,CBJ,NJ,0,1,0,0,1,1,3,3,0,7,-210,Home,6.5
2022-10-30,MIN,CHI,2,0,1,1,4,1,1,1,0,3,-225,Away,6.5
2022-10-30,NYR,ARI,0,2,1,0,3,0,2,0,0,2,-205,Away,6.5
2022-10-30,TOR,ANA,2,0,1,0,3,1,0,2,1,4,-178,Away,6.5
2022-10-30,WPG,VGK,0,0,1,0,1,0,0,1,1,2,-210,Home,6.5
2022-10-31,DET,BUF,0,2,1,0,3,1,3,4,0,8,-155,Home,6.5
2022-10-31,WAS,CAR,0,2,0,0,2,1,1,0,1,3,-205,Home,6
2022-10-31,LA,STL,1,4,0,0,5,0,1,0,0,1,-125,Home,6
2022-11-01,VGK,WAS,1,0,1,1,3,1,1,0,0,2,-170,Away,6
2022-11-01,OTT,TB,1,1,1,0,3,0,1,3,0,4,-195,Home,6.5
2022-11-01,PHI,NYR,0,0,0,0,0,0,0,0,1,1,-267,Home,6
2022-11-01,BOS,PIT,2,1,2,1,6,1,4,0,0,5,-120,Home,6.5
2022-11-01,MTL,MIN,0,0,1,0,1,0,3,1,0,4,-250,Home,6.5
2022-11-01,LA,DAL,0,2,0,0,2,1,4,0,0,5,-135,Home,6
2022-11-01,NYI,CHI,1,0,2,0,3,0,0,1,0,1,-195,Away,6
2022-11-01,NSH,EDM,1,1,2,0,4,4,1,2,0,7,-178,Home,6.5
2022-11-01,SEA,CGY,1,1,3,0,5,0,2,2,0,4,-235,Home,6.5
2022-11-01,FLA,ARI,0,1,0,0,1,0,1,2,0,3,-305,Away,6.5
2022-11-01,NJ,VAN,2,2,1,0,5,0,1,1,0,2,-115,Away,6.5
2022-11-01,ANA,SJ,3,1,1,1,6,2,2,1,0,5,-130,Home,6
2022-11-02,PHI,TOR,1,0,1,0,2,2,0,3,0,5,-335,Home,6.5
2022-11-02,PIT,BUF,1,1,1,0,3,0,1,5,0,6,-115,Away,6.5
2022-11-03,CAR,TB,1,1,1,1,4,0,3,0,0,3,-115,Home,6
2022-11-03,VGK,OTT,3,2,0,0,5,1,2,1,0,4,-140,Away,6.5
2022-11-03,WAS,DET,0,1,0,0,1,0,1,2,0,3,-125,Away,6
2022-11-03,BOS,NYR,1,0,4,0,5,0,1,1,0,2,-135,Home,6
2022-11-03,MTL,WPG,1,1,0,0,2,1,1,0,1,3,-210,Home,6
2022-11-03,NYI,STL,0,4,1,0,5,1,0,1,0,2,-115,Home,6
2022-11-03,SEA,MIN,0,3,1,0,4,0,0,0,0,0,-170,Home,6.5
2022-11-03,LA,CHI,0,1,0,0,1,0,1,0,1,2,-178,Away,6
2022-11-03,NJ,EDM,1,0,3,0,4,1,2,0,0,3,-165,Home,7
2022-11-03,NSH,CGY,1,2,1,0,4,0,0,1,0,1,-267,Home,6.5
2022-11-03,ANA,VAN,1,1,3,0,5,1,2,5,0,8,-170,Home,6.5
2022-11-03,DAL,ARI,4,1,2,0,7,0,0,2,0,2,-225,Away,6
2022-11-03,FLA,SJ,1,1,1,1,4,0,0,3,0,3,-205,Away,6.5
2022-11-04,CBJ,COL,0,2,1,0,3,2,1,3,0,6,-267,Home,6.5
2022-11-04,BUF,CAR,2,0,1,0,3,2,1,2,0,5,-210,Home,6.5
2022-11-05,NYI,DET,0,0,0,0,0,0,2,1,0,3,-125,Away,6
2022-11-05,COL,CBJ,1,3,1,0,5,1,0,0,0,1,-240,Away,6.5
2022-11-05,CHI,WPG,0,0,0,0,0,0,3,1,0,4,-235,Home,6.5
2022-11-05,DAL,EDM,1,3,2,0,6,0,1,1,0,2,-165,Home,6.5
2022-11-05,ARI,WAS,0,0,3,0,3,0,1,1,0,2,-305,Home,6
2022-11-05,BOS,TOR,0,1,0,0,1,1,1,0,0,2,-135,Home,6.5
2022-11-05,BUF,TB,1,1,1,0,3,1,1,3,0,5,-260,Home,6.5
2022-11-05,VGK,MTL,1,1,4,0,6,1,0,3,0,4,-210,Away,6.5
2022-11-05,PHI,OTT,1,1,0,0,2,1,0,0,0,1,-190,Home,6.5
2022-11-05,SEA,PIT,0,1,2,0,3,0,1,1,0,2,-195,Home,6.5
2022-11-05,NJ,CGY,3,0,0,1,4,1,1,1,0,3,-170,Home,6.5
2022-11-05,NSH,VAN,0,1,2,1,4,3,0,0,0,3,-120,Home,6.5
2022-11-05,ANA,SJ,2,0,2,1,5,1,2,1,0,4,-140,Home,6.5
2022-11-05,FLA,LA,1,1,2,0,4,0,3,2,0,5,-115,Away,6.5
2022-11-06,DET,NYR,0,2,0,1,3,2,0,0,0,2,-235,Home,6.5
2022-11-06,TOR,CAR,0,1,2,0,3,1,0,0,0,1,-170,Home,6.5
2022-11-06,FLA,ANA,1,1,3,0,5,0,2,1,0,3,-190,Away,6.5
2022-11-07,CGY,NYI,2,1,0,0,3,1,0,2,1,4,-125,Away,6
2022-11-07,STL,BOS,0,1,0,0,1,1,0,2,0,3,-205,Home,6.5
2022-11-07,EDM,WAS,0,2,2,0,4,1,3,1,0,5,-170,Away,6.5
2022-11-08,ARI,BUF,2,0,2,0,4,1,0,0,0,1,-240,Home,6.5
2022-11-08,CGY,NJ,1,0,1,0,2,0,2,1,0,3,-140,Home,6.5
2022-11-08,VGK,TOR,2,0,1,1,4,1,2,0,0,3,-115,Home,6.5
2022-11-08,MTL,DET,2,0,0,1,3,1,0,1,0,2,-165,Home,6
2022-11-08,NYI,NYR,1,0,3,0,4,1,2,0,0,3,-170,Home,6
2022-11-08,STL,PHI,0,0,1,0,1,0,3,2,0,5,-135,Away,6
2022-11-08,VAN,OTT,1,1,4,0,6,2,0,2,0,4,-125,Home,6.5
2022-11-08,EDM,TB,1,2,0,0,3,1,0,1,0,2,-170,Home,6.5
2022-11-08,DAL,WPG,0,1,0,0,1,0,4,1,0,5,-115,Away,6
2022-11-08,NSH,SEA,0,1,0,0,1,4,0,1,0,5,-120,Home,6
2022-11-08,MIN,LA,0,0,0,0,0,0,0,1,0,1,-115,Home,6.5
2022-11-09,CAR,FLA,0,0,0,0,0,1,0,2,0,3,-120,Away,6.5
2022-11-09,PIT,WAS,0,3,1,0,4,0,0,1,0,1,-130,Away,6.5
2022-11-09,VAN,MTL,0,0,2,0,2,3,1,1,0,5,-165,Away,6.5
2022-11-09,MIN,ANA,0,1,3,0,4,0,1,0,0,1,-165,Away,6.5
2022-11-10,CGY,BOS,1,0,0,0,1,1,1,1,0,3,-195,Home,6
2022-11-10,EDM,CAR,0,1,1,0,2,1,3,3,0,7,-140,Home,6.5
2022-11-10,VGK,BUF,1,2,4,0,7,1,1,2,0,4,-170,Away,6.5
2022-11-10,NYR,DET,1,1,6,0,8,1,1,0,0,2,-165,Away,6
2022-11-10,OTT,NJ,2,0,1,0,3,2,1,0,1,4,-190,Home,6.5
2022-11-10,PHI,CBJ,0,1,1,0,2,2,1,2,0,5,0,Even,6.5
2022-11-10,ARI,NYI,0,0,2,0,2,0,0,0,0,0,-292,Home,6
2022-11-10,SJ,STL,1,1,1,0,3,1,2,2,0,5,-170,Home,6
2022-11-10,NSH,COL,1,1,1,0,3,1,4,0,0,5,-195,Home,6.5
2022-11-10,CHI,LA,1,0,0,0,1,0,1,0,1,2,-285,Home,6.5
2022-11-11,TB,WAS,0,0,1,0,1,1,2,2,0,5,-140,Away,6
2022-11-11,PIT,TOR,1,1,2,0,4,1,1,0,0,2,-155,Home,6.5
2022-11-11,SJ,DAL,2,2,1,0,5,2,0,2,0,4,-240,Home,6
2022-11-11,MIN,SEA,1,0,0,0,1,0,0,0,0,0,-125,Away,6
2022-11-12,OTT,PHI,1,1,2,0,4,1,0,0,0,1,-130,Away,6.5
2022-11-12,EDM,FLA,0,1,3,0,4,0,0,2,0,2,-170,Home,7
2022-11-12,ARI,NJ,1,1,0,0,2,2,2,0,0,4,-305,Home,6.5
2022-11-12,BOS,BUF,0,1,2,0,3,1,0,0,0,1,-190,Away,6.5
2022-11-12,PIT,MTL,0,2,2,0,4,1,0,3,1,5,-170,Away,6.5
2022-11-12,CBJ,NYI,0,2,1,0,3,0,2,1,1,4,-250,Home,6
2022-11-12,VAN,TOR,2,0,0,0,2,0,3,0,0,3,-170,Home,6.5
2022-11-12,NYR,NSH,0,1,0,0,1,1,1,0,0,2,-115,Home,6
2022-11-12,CAR,COL,0,1,0,0,1,2,0,2,0,4,-120,Home,6.5
2022-11-12,CHI,ANA,1,1,1,0,3,2,0,0,0,2,-140,Home,6.5
2022-11-12,STL,VGK,1,2,0,0,3,1,1,0,0,2,-205,Home,6.5
2022-11-12,WPG,CGY,1,1,0,0,2,2,1,0,0,3,-170,Home,6
2022-11-12,DET,LA,1,0,2,0,3,2,2,0,0,4,-220,Home,6
2022-11-13,DAL,PHI,2,1,2,0,5,0,1,0,0,1,-195,Away,6.5
2022-11-13,SJ,MIN,0,0,2,1,3,1,0,1,0,2,-210,Home,6
2022-11-13,VAN,BOS,1,0,1,0,2,2,2,1,0,5,-240,Home,6.5
2022-11-13,ARI,NYR,0,0,1,0,1,0,2,2,0,4,-385,Home,6
2022-11-13,WAS,TB,0,1,2,0,3,4,0,2,0,6,-190,Home,6
2022-11-13,WPG,SEA,0,1,1,1,3,1,0,1,0,2,-170,Home,6
2022-11-14,NYI,OTT,1,1,2,0,4,0,1,1,0,2,-130,Away,6
2022-11-14,CAR,CHI,2,1,0,0,3,0,0,0,0,0,-240,Away,6
2022-11-14,LA,CGY,2,1,2,0,5,4,2,0,0,6,-170,Home,6
2022-11-14,STL,COL,0,2,1,0,3,0,1,1,0,2,-195,Home,6
2022-11-15,DAL,TB,1,2,1,0,4,1,2,1,1,5,-130,Home,6
2022-11-15,NJ,MTL,0,3,2,0,5,0,1,0,0,1,-195,Away,6.5
2022-11-15,TOR,PIT,2,2,1,0,5,0,2,0,0,2,-115,Away,6.5
2022-11-15,VAN,BUF,2,3,0,0,5,1,2,1,0,4,0,Even,6.5
2022-11-15,WAS,FLA,0,1,1,0,2,1,1,3,0,5,-210,Home,6.5
2022-11-15,PHI,CBJ,0,2,2,0,4,1,1,2,1,5,-115,Away,6
2022-11-15,MIN,NSH,0,0,1,0,1,2,0,0,0,2,0,Even,6
2022-11-15,DET,ANA,1,1,0,0,2,1,0,1,1,3,-120,Away,6.5
2022-11-15,SJ,VGK,0,1,4,0,5,1,1,0,0,2,-285,Home,6.5
2022-11-16,BUF,OTT,0,1,0,0,1,1,1,2,0,4,-170,Home,6.5
2022-11-16,STL,CHI,1,3,1,0,5,0,2,0,0,2,-178,Away,5.5
2022-11-16,LA,EDM,1,1,1,0,3,0,1,0,0,1,-135,Home,6.5
2022-11-17,CGY,TB,0,0,1,0,1,1,1,2,0,4,-125,Home,6
2022-11-17,COL,CAR,1,1,0,1,3,0,1,1,0,2,-135,Home,6
2022-11-17,DAL,FLA,4,1,1,0,6,0,3,1,0,4,-165,Home,6.5
2022-11-17,MTL,CBJ,0,2,2,0,4,2,0,4,0,6,-115,Home,6.5
2022-11-17,NJ,TOR,1,1,0,1,3,1,0,1,0,2,-145,Home,6.5
2022-11-17,PHI,BOS,0,0,1,0,1,0,1,3,0,4,-355,Home,6
2022-11-17,ANA,WPG,1,0,1,0,2,0,1,2,0,3,-220,Home,6
2022-11-17,NYI,NSH,1,1,2,0,4,3,1,1,0,5,-115,Home,6
2022-11-17,PIT,MIN,2,1,3,0,6,0,2,2,0,4,0,Even,6.5
2022-11-17,WAS,STL,0,2,2,0,4,3,1,0,1,5,-115,Home,6
2022-11-17,ARI,VGK,0,0,1,0,1,0,1,3,0,4,-420,Home,6.5
2022-11-17,NYR,SEA,1,0,1,0,2,1,0,1,1,3,-140,Away,6
2022-11-17,DET,SJ,1,2,4,0,7,2,0,2,0,4,-120,Home,6
2022-11-18,LA,VAN,0,1,0,0,1,0,3,1,0,4,-115,Home,6.5
2022-11-19,NJ,OTT,2,2,1,0,5,0,1,0,0,1,-120,Away,6.5
2022-11-19,CGY,FLA,1,2,1,1,5,0,2,2,0,4,-135,Home,6
2022-11-19,BUF,TOR,0,1,1,0,2,3,1,1,0,5,-305,Home,6.5
2022-11-19,CHI,BOS,0,1,0,0,1,1,3,2,0,6,-480,Home,6
2022-11-19,COL,WAS,1,1,2,0,4,0,0,0,0,0,-120,Away,6
2022-11-19,DET,CBJ,1,3,2,0,6,0,1,0,0,1,-140,Away,6.5
2022-11-19,PHI,MTL,2,1,1,0,4,2,1,1,1,5,-130,Home,6
2022-11-19,PIT,WPG,0,0,3,0,3,0,0,0,0,0,-125,Away,6.5
2022-11-19,ANA,STL,0,1,1,0,2,2,3,1,0,6,-190,Home,6
2022-11-19,CAR,MIN,1,0,0,0,1,0,0,1,1,2,-125,Away,6
2022-11-19,NYI,DAL,0,2,0,0,2,0,2,3,0,5,-160,Home,6
2022-11-19,TB,NSH,0,1,1,1,3,1,0,1,0,2,-130,Away,6
2022-11-19,LA,SEA,0,1,1,0,2,1,0,1,1,3,-125,Home,6
2022-11-19,VGK,EDM,1,1,1,0,3,1,1,1,1,4,-115,Away,6.5
2022-11-19,NYR,SJ,0,0,2,0,2,0,0,1,0,1,-170,Away,6
2022-11-20,FLA,CBJ,1,1,1,0,3,1,1,3,0,5,-260,Away,6.5
2022-11-20,PIT,CHI,1,2,2,0,5,0,2,1,0,3,-235,Away,6.5
2022-11-21,BOS,TB,1,3,1,0,5,1,0,2,0,3,-115,Home,6
2022-11-21,CGY,PHI,2,1,2,0,5,1,0,1,0,2,-225,Away,6
2022-11-21,EDM,NJ,1,0,1,0,2,1,2,2,0,5,-155,Home,6.5
2022-11-21,CAR,WPG,0,0,3,0,3,1,1,1,1,4,-178,Away,6
2022-11-21,NYI,TOR,1,0,1,1,3,0,2,0,0,2,-175,Home,6
2022-11-21,ANA,STL,1,0,0,0,1,1,0,2,0,3,-210,Home,6
2022-11-21,ARI,NSH,0,2,1,0,3,1,0,2,1,4,-267,Home,6
2022-11-21,COL,DAL,1,0,1,1,3,0,1,1,0,2,-115,Home,6
2022-11-21,VGK,VAN,0,2,3,0,5,0,1,3,0,4,-140,Away,6.5
2022-11-21,OTT,SJ,1,0,0,0,1,1,3,1,0,5,-115,Away,6
2022-11-22,BUF,MTL,3,1,3,0,7,1,1,0,0,2,0,Even,6.5
2022-11-22,NYR,LA,0,3,2,0,5,2,0,1,0,3,-140,Away,6
2022-11-23,ARI,CAR,1,0,3,0,4,0,0,0,0,0,-385,Home,6
2022-11-23,BOS,FLA,1,0,1,0,2,1,3,1,0,5,-120,Home,6.5
2022-11-23,CGY,PIT,0,1,0,0,1,1,0,0,1,2,-125,Home,6.5
2022-11-23,MTL,CBJ,0,0,3,0,3,0,0,1,0,1,-125,Home,6.5
2022-11-23,NSH,DET,0,0,0,0,0,0,2,1,0,3,-130,Home,6
2022-11-23,STL,BUF,0,1,1,0,2,1,3,2,0,6,-135,Away,6.5
2022-11-23,TOR,NJ,2,0,0,0,2,0,0,1,0,1,-135,Home,6.5
2022-11-23,WPG,MIN,0,1,0,0,1,1,2,3,0,6,-160,Home,6
2022-11-23,EDM,NYI,0,0,0,0,0,0,3,0,0,3,-120,Home,6
2022-11-23,PHI,WAS,1,1,0,0,2,1,0,1,1,3,-250,Home,6
2022-11-23,CHI,DAL,0,3,1,0,4,1,0,5,0,6,-320,Home,6
2022-11-23,NYR,ANA,1,1,0,0,2,1,2,0,0,3,-160,Away,6
2022-11-23,OTT,VGK,1,0,0,0,1,1,1,2,0,4,-250,Home,6.5
2022-11-23,SJ,SEA,2,1,2,0,5,1,3,4,0,8,-190,Home,6
2022-11-23,VAN,COL,1,1,2,0,4,2,1,0,0,3,-205,Home,6.5
2022-11-25,CAR,BOS,2,0,0,0,2,0,1,1,1,3,-155,Home,6
2022-11-25,CGY,WAS,0,0,0,0,0,1,1,1,0,3,-125,Away,6
2022-11-25,MTL,CHI,1,1,0,1,3,0,1,1,0,2,-125,Home,6.5
2022-11-25,TOR,MIN,2,1,1,0,4,1,1,1,0,3,-115,Home,6
2022-11-25,OTT,ANA,2,2,1,0,5,0,0,1,0,1,-155,Away,6.5
2022-11-25,PIT,PHI,2,2,0,0,4,0,0,1,0,1,-240,Away,6
2022-11-25,ARI,DET,0,2,1,0,3,1,2,0,1,4,-205,Home,6
2022-11-25,NJ,BUF,0,3,0,0,3,0,1,0,0,1,-150,Away,6.5
2022-11-25,NYI,CBJ,1,1,1,0,3,0,2,0,0,2,-195,Away,6
2022-11-25,SEA,VGK,2,2,0,0,4,2,0,0,0,2,-190,Home,6.5
2022-11-25,STL,TB,1,1,0,0,2,3,1,1,0,5,-195,Home,6
2022-11-25,WPG,DAL,2,1,1,1,5,2,0,2,0,4,-170,Home,6
2022-11-25,LA,SJ,2,1,2,0,5,1,1,0,0,2,-145,Away,6
2022-11-26,EDM,NYR,0,0,4,0,4,1,2,0,0,3,-160,Home,6.5
2022-11-26,CGY,CAR,1,1,0,0,2,1,1,1,0,3,-130,Home,6
2022-11-26,STL,FLA,1,0,3,1,5,3,1,0,0,4,-205,Home,6.5
2022-11-26,TOR,PIT,1,2,1,0,4,0,0,1,0,1,-135,Home,6.5
2022-11-26,WAS,NJ,0,0,1,0,1,1,2,2,0,5,-195,Home,6
2022-11-26,PHI,NYI,1,1,0,0,2,1,1,3,0,5,-240,Home,6
2022-11-26,DAL,COL,0,1,0,0,1,2,1,1,0,4,-178,Home,6
2022-11-26,VAN,VGK,2,3,0,0,5,0,0,1,0,1,-195,Home,6.5
2022-11-27,ARI,MIN,0,1,2,0,3,1,1,2,0,4,-305,Home,6
2022-11-27,WPG,CHI,1,4,2,0,7,0,2,0,0,2,-170,Away,6
2022-11-27,SEA,ANA,3,1,1,0,5,1,3,0,0,4,-178,Away,6
2022-11-27,VAN,SJ,1,0,2,1,4,0,1,2,0,3,-115,Away,6.5
2022-11-27,OTT,LA,1,1,0,1,3,0,2,0,0,2,-160,Home,6.5
2022-11-28,VGK,CBJ,2,0,0,1,3,0,1,1,0,2,-285,Away,6.5
2022-11-28,NJ,NYR,2,2,1,0,5,2,0,1,0,3,-120,Home,6
2022-11-28,TB,BUF,2,1,2,1,6,2,1,2,0,5,-145,Away,6.5
2022-11-28,TOR,DET,2,2,0,0,4,1,0,1,0,2,-155,Away,6
2022-11-28,DAL,STL,0,1,3,0,4,0,0,1,0,1,-120,Away,6
2022-11-28,FLA,EDM,1,0,2,0,3,0,1,2,1,4,-115,Home,6.5
2022-11-29,CAR,PIT,0,2,0,1,3,1,0,1,0,2,-115,Home,6
2022-11-29,SJ,MTL,1,0,3,0,4,0,0,0,0,0,0,Even,6
2022-11-29,TB,BOS,0,1,0,0,1,1,0,2,0,3,-178,Home,6
2022-11-29,NYI,PHI,1,0,0,0,1,2,0,1,0,3,-195,Away,5.5
2022-11-29,ANA,NSH,0,0,1,0,1,0,1,0,1,2,-240,Home,6.5
2022-11-29,COL,WPG,0,0,0,0,0,1,2,2,0,5,-135,Away,6
2022-11-29,FLA,CGY,0,2,0,0,2,3,1,2,0,6,-155,Home,6.5
2022-11-29,WAS,VAN,3,1,1,0,5,1,0,0,0,1,-115,Home,6.5
2022-11-29,SEA,LA,3,5,0,1,9,3,3,2,0,8,-130,Home,6
2022-11-30,BUF,DET,2,2,0,1,5,1,0,3,0,4,-130,Home,6.5
2022-11-30,NYR,OTT,1,1,1,0,3,0,1,0,0,1,-115,Home,6.5
2022-11-30,SJ,TOR,0,1,0,0,1,0,1,2,0,3,-320,Home,6.5
2022-11-30,EDM,CHI,0,2,3,0,5,0,1,3,0,4,-225,Away,6
2022-12-01,COL,BUF,1,4,1,0,6,2,1,1,0,4,-178,Away,6.5
2022-12-01,VGK,PIT,2,0,1,0,3,0,2,2,0,4,-120,Home,6.5
2022-12-01,NSH,NJ,2,0,1,1,4,0,3,0,0,3,-205,Home,6
2022-12-01,TB,PHI,1,2,1,0,4,0,0,1,0,1,-225,Away,6
2022-12-01,CAR,STL,0,3,3,0,6,1,2,1,0,4,-140,Away,5.5
2022-12-01,EDM,MIN,1,1,1,0,3,0,3,2,0,5,-165,Home,6.5
2022-12-01,ANA,DAL,0,0,0,0,0,1,2,2,0,5,-320,Home,6
2022-12-01,MTL,CGY,1,0,1,0,2,0,1,0,0,1,-320,Home,6
2022-12-01,FLA,VAN,3,1,1,0,5,0,1,0,0,1,-130,Away,6.5
2022-12-01,WAS,SEA,2,0,0,0,2,0,1,1,1,3,-115,Home,6
2022-12-01,ARI,LA,1,2,0,0,3,1,2,2,0,5,-250,Home,6
2022-12-02,OTT,NYR,0,1,1,1,3,1,0,1,0,2,-190,Home,6.5
2022-12-02,NSH,NYI,1,1,2,0,4,0,0,1,0,1,-165,Home,6
2022-12-02,CBJ,WPG,2,2,0,0,4,0,0,1,0,1,-210,Home,6.5
2022-12-03,ANA,MIN,1,2,1,0,4,2,0,2,1,5,-305,Home,6
2022-12-03,COL,BOS,0,0,1,0,1,2,1,2,0,5,-165,Home,6
2022-12-03,VGK,DET,1,2,1,0,4,0,1,0,0,1,-140,Away,6.5
2022-12-03,MTL,EDM,1,2,0,0,3,0,4,1,0,5,-250,Home,6.5
2022-12-03,NJ,PHI,0,1,2,0,3,0,1,1,0,2,-215,Away,6
2022-12-03,SJ,OTT,2,0,0,0,2,1,2,2,0,5,-145,Home,6.5
2022-12-03,STL,PIT,1,1,0,0,2,3,2,1,0,6,-190,Home,6
2022-12-03,CHI,NYR,1,2,2,0,5,0,1,1,0,2,-278,Home,6
2022-12-03,TOR,TB,0,2,1,0,3,0,1,2,1,4,-135,Home,6
2022-12-03,ARI,VAN,1,1,0,0,2,1,0,1,1,3,-210,Home,6
2022-12-03,FLA,SEA,2,1,2,0,5,0,1,0,0,1,-120,Away,6
2022-12-03,WAS,CGY,1,0,1,0,2,1,1,3,0,5,-165,Home,6
2022-12-03,CAR,LA,2,1,1,0,4,0,0,2,0,2,-145,Away,6
2022-12-04,ANA,WPG,1,1,0,0,2,0,2,3,0,5,-285,Home,6
2022-12-04,MIN,DAL,1,3,1,1,6,0,1,4,0,5,-160,Home,6
2022-12-04,DET,CBJ,2,1,1,0,4,0,1,1,0,2,-125,Away,6.5
2022-12-04,SJ,BUF,2,0,1,0,3,1,3,2,0,6,-160,Home,6.5
2022-12-04,CHI,NYI,0,0,0,0,0,0,3,0,0,3,-305,Home,5.5
2022-12-05,COL,PHI,1,0,2,0,3,2,1,2,0,5,-205,Away,5.5
2022-12-05,VGK,BOS,2,1,0,1,4,0,2,1,0,3,-195,Home,6
2022-12-05,STL,NYR,1,3,0,0,4,2,1,3,0,6,-170,Home,6
2022-12-05,WAS,EDM,0,2,1,0,3,0,2,0,0,2,-160,Home,6.5
2022-12-05,ARI,CGY,0,1,1,0,2,2,0,1,0,3,-355,Home,6
2022-12-05,MTL,VAN,4,0,2,0,6,0,2,4,1,7,-260,Home,6.5
2022-12-06,CHI,NJ,0,0,0,0,0,1,2,0,0,3,-430,Home,6.5
2022-12-06,CBJ,PIT,1,0,0,0,1,0,3,1,0,4,-292,Home,6.5
2022-12-06,DET,TB,0,1,3,0,4,0,0,2,0,2,-260,Home,6
2022-12-06,LA,OTT,4,1,0,0,5,1,0,1,0,2,-115,Home,6.5
2022-12-06,STL,NYI,1,2,4,0,7,1,0,3,0,4,-195,Home,5.5
2022-12-06,FLA,WPG,1,0,1,0,2,2,2,1,0,5,-115,Away,6
2022-12-06,TOR,DAL,2,1,1,0,4,0,0,0,0,0,-120,Home,6
2022-12-06,CAR,ANA,1,2,0,0,3,2,1,0,1,4,-305,Away,6
2022-12-06,MTL,SEA,1,3,0,0,4,1,1,0,0,2,-278,Home,6
2022-12-07,WAS,PHI,0,1,3,0,4,1,0,0,0,1,-140,Away,6
2022-12-07,BUF,CBJ,6,3,0,0,9,0,2,2,0,4,-155,Away,6.5
2022-12-07,MIN,CGY,2,0,1,0,3,0,3,2,0,5,-155,Home,6
2022-12-07,BOS,COL,0,2,2,0,4,0,0,0,0,0,-178,Away,6
2022-12-07,ARI,EDM,0,1,1,0,2,2,3,3,0,8,-305,Home,6.5
2022-12-07,NYR,VGK,1,0,4,0,5,0,1,0,0,1,-125,Home,6
2022-12-07,VAN,SJ,2,2,1,1,6,1,2,2,0,5,-120,Away,6.5
2022-12-08,LA,TOR,0,0,0,0,0,0,4,1,0,5,-178,Home,6
2022-12-08,NSH,TB,1,1,0,0,2,2,0,3,0,5,-180,Home,6
2022-12-08,DET,FLA,0,1,0,0,1,1,4,0,0,5,-220,Home,6.5
2022-12-08,WPG,STL,1,2,2,0,5,0,1,1,0,2,-125,Away,6
2022-12-08,OTT,DAL,2,0,1,0,3,2,0,1,1,4,-205,Home,6.5
2022-12-09,CGY,CBJ,0,0,1,0,1,1,1,1,0,3,-267,Away,6.5
2022-12-09,NYI,NJ,2,3,1,0,6,1,1,2,0,4,-225,Home,6
2022-12-09,PIT,BUF,0,1,2,1,4,0,2,1,0,3,-155,Away,6.5
2022-12-09,SEA,WAS,1,0,0,0,1,0,2,2,0,4,-145,Home,6
2022-12-09,WPG,CHI,1,1,1,0,3,0,1,0,0,1,-145,Away,6
2022-12-09,MIN,EDM,1,1,0,0,2,2,1,2,0,5,-125,Home,6.5
2022-12-09,NYR,COL,0,1,0,1,2,1,0,0,0,1,-160,Away,5.5
2022-12-09,BOS,ARI,1,1,1,0,3,1,1,2,0,4,-355,Away,6
2022-12-09,PHI,VGK,0,1,0,0,1,1,0,0,1,2,-267,Home,6
2022-12-09,SJ,ANA,1,3,2,0,6,0,1,0,0,1,-115,Away,6.5
2022-12-10,OTT,NSH,0,1,2,0,3,0,1,1,0,2,-135,Home,6.5
2022-12-10,DET,DAL,1,1,0,0,2,1,1,0,1,3,-205,Home,6.5
2022-12-10,FLA,TB,0,1,0,0,1,1,0,3,0,4,-140,Home,6.5
2022-12-10,BUF,PIT,0,0,1,0,1,2,0,1,0,3,-220,Home,6.5
2022-12-10,CGY,TOR,2,1,1,0,4,2,1,1,1,5,-170,Home,6
2022-12-10,LA,MTL,2,0,2,0,4,0,0,2,0,2,-178,Away,6
2022-12-10,CAR,NYI,0,1,2,0,3,0,0,0,0,0,-135,Away,5.5
2022-12-10,MIN,VAN,1,1,1,0,3,0,0,0,0,0,-115,Home,6.5
2022-12-11,COL,STL,0,1,1,1,3,0,0,2,0,2,-120,Away,6
2022-12-11,LA,CBJ,0,3,2,0,5,2,3,0,1,6,-155,Away,6.5
2022-12-11,SEA,FLA,1,1,3,0,5,0,1,1,0,2,-160,Home,6.5
2022-12-11,PHI,ARI,0,3,1,0,4,1,2,1,1,5,0,Even,5.5
2022-12-11,WAS,WPG,0,4,1,0,5,0,0,2,0,2,-135,Home,6
2022-12-11,BOS,VGK,0,1,2,0,3,1,0,0,0,1,-165,Away,6
2022-12-12,CGY,MTL,0,1,0,0,1,0,0,1,1,2,-205,Away,6
2022-12-12,DAL,PIT,1,0,0,0,1,1,0,1,0,2,-130,Home,6.5
2022-12-12,NJ,NYR,2,1,0,0,3,1,2,0,1,4,-120,Home,6
2022-12-12,ANA,OTT,0,0,0,0,0,2,0,1,0,3,-235,Home,6.5
2022-12-12,EDM,MIN,1,0,0,0,1,1,1,0,0,2,-125,Home,6.5
2022-12-12,NSH,STL,0,0,0,0,0,0,0,0,1,1,-115,Away,6
2022-12-13,ANA,TOR,0,0,0,0,0,2,2,3,0,7,-480,Home,6.5
2022-12-13,CAR,DET,1,0,0,0,1,0,0,0,0,0,-178,Away,6
2022-12-13,CBJ,FLA,0,0,0,0,0,1,2,1,0,4,-278,Home,6.5
2022-12-13,DAL,NJ,0,2,2,0,4,0,1,0,0,1,-165,Home,6.5
2022-12-13,LA,BUF,0,0,0,0,0,0,0,6,0,6,-115,Away,6.5
2022-12-13,NYI,BOS,1,1,1,0,3,2,1,0,1,4,-267,Home,5.5
2022-12-13,SEA,TB,1,0,1,0,2,2,3,1,0,6,-205,Home,6
2022-12-13,EDM,NSH,3,2,1,0,6,1,2,0,0,3,-135,Away,6.5
2022-12-13,VGK,WPG,2,1,3,0,6,1,2,2,0,5,-140,Home,6
2022-12-13,PHI,COL,1,0,1,0,2,0,2,1,0,3,-240,Home,6
2022-12-13,WAS,CHI,2,2,3,0,7,1,1,1,0,3,-210,Away,6
2022-12-13,ARI,SJ,1,0,1,0,2,2,1,0,0,3,-170,Home,6
2022-12-14,MTL,OTT,0,0,2,0,2,0,3,0,0,3,-220,Home,6.5
2022-12-14,DET,MIN,0,1,0,0,1,1,2,1,0,4,-267,Home,6
2022-12-14,VAN,CGY,2,1,0,1,4,2,1,0,0,3,-190,Home,6.5
2022-12-15,ANA,MTL,2,0,3,0,5,0,0,2,0,2,-155,Home,6
2022-12-15,CBJ,TB,0,1,0,0,1,1,0,3,0,4,-292,Home,6.5
2022-12-15,DAL,WAS,0,0,2,0,2,0,1,0,0,1,-115,Away,6
2022-12-15,LA,BOS,0,0,2,1,3,0,2,0,0,2,-250,Home,6
2022-12-15,PHI,NJ,0,1,1,0,2,1,0,0,0,1,-305,Home,6
2022-12-15,PIT,FLA,0,2,2,0,4,1,0,1,0,2,0,Even,6.5
2022-12-15,SEA,CAR,0,1,1,0,2,2,1,0,0,3,-190,Home,6
2022-12-15,TOR,NYR,1,0,0,0,1,1,1,1,0,3,-125,Away,6
2022-12-15,NSH,WPG,1,0,0,0,1,1,0,0,1,2,-165,Home,6
2022-12-15,VGK,CHI,1,1,2,0,4,0,0,1,0,1,-205,Away,6
2022-12-15,BUF,COL,2,1,1,0,4,0,0,2,0,2,-190,Home,6.5
2022-12-15,STL,EDM,1,0,2,1,4,1,1,1,0,3,-170,Home,6.5
2022-12-16,CHI,MIN,0,0,1,0,1,1,2,1,0,4,-440,Home,6
2022-12-16,STL,CGY,1,1,3,0,5,1,0,1,0,2,-235,Home,6
2022-12-16,NYI,ARI,2,1,1,0,4,1,2,2,0,5,-178,Away,5.5
2022-12-17,CBJ,BOS,0,1,1,0,2,1,1,2,0,4,-455,Home,6.5
2022-12-17,OTT,DET,2,1,3,0,6,2,1,0,0,3,0,Even,6
2022-12-17,ANA,EDM,2,1,1,0,4,1,1,1,0,3,-335,Home,6.5
2022-12-17,DAL,CAR,1,1,2,0,4,2,1,1,1,5,-170,Home,5.5
2022-12-17,NYR,PHI,1,2,3,0,6,1,1,1,0,3,-165,Away,6
2022-12-17,TB,MTL,2,2,1,0,5,0,0,1,0,1,-260,Away,6
2022-12-17,TOR,WAS,1,1,0,0,2,2,1,2,0,5,-135,Away,6
2022-12-17,FLA,NJ,1,2,1,0,4,0,1,1,0,2,-140,Home,6.5
2022-12-17,BUF,ARI,1,1,3,0,5,1,1,0,0,2,-170,Away,6.5
2022-12-17,NSH,COL,0,0,1,0,1,0,2,1,0,3,-170,Home,5.5
2022-12-17,NYI,VGK,1,2,2,0,5,0,1,1,0,2,-170,Home,6
2022-12-17,WPG,VAN,1,2,2,0,5,0,0,1,0,1,-130,Away,6.5
2022-12-17,SJ,LA,1,1,0,0,2,1,1,0,1,3,-160,Home,6
2022-12-18,OTT,MIN,0,0,2,0,2,1,2,1,0,4,-210,Home,6
2022-12-18,PIT,CAR,0,1,1,0,2,0,1,2,0,3,-130,Home,6
2022-12-18,NYR,CHI,3,2,2,0,7,0,1,0,0,1,-260,Away,5.5
2022-12-18,WPG,SEA,1,1,0,0,2,0,1,2,0,3,-150,Home,6
2022-12-18,CGY,SJ,1,1,3,0,5,1,0,1,0,2,-190,Away,6
2022-12-19,DAL,CBJ,0,1,1,0,2,0,0,1,0,1,-250,Away,6.5
2022-12-19,DET,WAS,2,0,1,0,3,0,2,1,1,4,-178,Home,6
2022-12-19,FLA,BOS,0,3,0,0,3,3,2,2,0,7,-205,Home,6.5
2022-12-19,EDM,NSH,1,1,1,0,3,1,2,0,1,4,-115,Away,6.5
2022-12-19,NYI,COL,0,0,0,0,0,0,0,0,1,1,-155,Home,5.5
2022-12-19,BUF,VGK,0,3,0,0,3,0,0,2,0,2,-155,Home,6.5
2022-12-19,MTL,ARI,0,2,0,1,3,0,2,0,0,2,-125,Home,6
2022-12-19,STL,VAN,0,3,2,0,5,0,1,0,0,1,0,Even,6
2022-12-20,CBJ,PHI,0,2,1,0,3,1,2,2,0,5,-178,Home,6
2022-12-20,NJ,CAR,0,0,1,0,1,1,2,1,0,4,-120,Home,6
2022-12-20,NYR,PIT,1,0,1,0,2,0,2,1,0,3,-135,Home,5.5
2022-12-20,TB,TOR,0,0,1,0,1,1,1,2,0,4,-140,Home,6
2022-12-20,OTT,WPG,1,0,0,0,1,3,2,0,0,5,-125,Home,6.5
2022-12-20,STL,SEA,0,0,2,0,2,1,3,1,0,5,-190,Home,6
2022-12-20,ANA,LA,0,1,0,0,1,0,2,2,0,4,-278,Home,6.5
2022-12-20,CGY,SJ,2,1,4,0,7,1,1,1,0,3,-190,Away,6
2022-12-21,NJ,FLA,1,0,3,0,4,1,1,0,0,2,-135,Home,6.5
2022-12-21,TB,DET,2,1,1,0,4,2,1,4,0,7,-130,Away,6.5
2022-12-21,MTL,COL,1,0,0,0,1,0,0,1,1,2,-285,Home,5.5
2022-12-21,NSH,CHI,1,1,2,0,4,0,2,0,0,2,-205,Away,6
2022-12-21,EDM,DAL,1,2,3,0,6,1,2,0,0,3,-145,Home,6.5
2022-12-21,ARI,VGK,0,1,1,0,2,0,1,4,0,5,-320,Home,6
2022-12-21,MIN,ANA,0,1,3,0,4,0,1,0,0,1,-278,Away,6.5
2022-12-22,PHI,TOR,1,0,2,0,3,0,2,2,0,4,-335,Home,6
2022-12-22,CAR,PIT,2,0,1,1,4,1,1,1,0,3,-135,Home,5.5
2022-12-22,NYI,NYR,1,2,0,0,3,1,1,3,0,5,-165,Home,5.5
2022-12-22,WAS,OTT,1,1,0,1,3,1,0,1,0,2,-125,Away,6.5
2022-12-22,WPG,BOS,2,0,0,0,2,0,2,1,0,3,-240,Home,6
2022-12-22,SEA,VAN,1,3,1,0,5,1,1,3,1,6,-115,Away,6.5
2022-12-22,CGY,LA,1,0,2,0,3,1,0,2,1,4,-120,Away,6
2022-12-22,MIN,SJ,1,1,0,0,2,2,2,1,0,5,-170,Away,6
2022-12-23,BOS,NJ,0,4,0,0,4,1,0,2,0,3,-120,Away,6
2022-12-23,PHI,CAR,1,1,3,0,5,3,3,0,0,6,-355,Home,6
2022-12-23,WPG,WAS,0,0,1,0,1,1,1,2,0,4,-175,Home,6
2022-12-23,FLA,NYI,1,0,0,0,1,0,2,3,0,5,-120,Away,6
2022-12-23,COL,NSH,0,1,1,1,3,1,1,0,0,2,-120,Away,5.5
2022-12-23,MTL,DAL,1,1,0,0,2,0,1,3,0,4,-335,Home,6
2022-12-23,CBJ,CHI,0,1,1,0,2,2,2,1,0,5,0,Even,6.5
2022-12-23,VAN,EDM,0,2,3,0,5,2,0,0,0,2,-225,Home,6.5
2022-12-23,LA,ARI,0,1,0,0,1,1,0,0,1,2,-170,Away,6
2022-12-23,STL,VGK,0,3,1,0,4,1,2,1,1,5,-165,Home,5.5
2022-12-23,CGY,ANA,1,1,0,1,3,1,0,1,0,2,-225,Away,6
2022-12-27,BOS,OTT,0,1,1,0,2,0,2,0,1,3,-205,Away,6.5
2022-12-27,CHI,CAR,0,0,0,0,0,2,0,1,0,3,-480,Home,6
2022-12-27,WAS,NYR,1,2,1,0,4,0,0,0,0,0,-160,Home,6
2022-12-27,PIT,NYI,1,0,0,0,1,1,3,1,0,5,-130,Away,5.5
2022-12-27,DAL,NSH,1,1,1,0,3,0,2,0,0,2,-135,Away,6
2022-12-27,MIN,WPG,2,1,1,0,4,1,0,0,0,1,-120,Away,6
2022-12-27,TOR,STL,2,2,0,1,5,1,2,1,0,4,-178,Away,6
2022-12-27,COL,ARI,1,1,1,0,3,2,2,2,0,6,-235,Away,5.5
2022-12-27,EDM,CGY,0,1,1,0,2,0,1,0,0,1,-140,Home,6.5
2022-12-27,SJ,VAN,1,0,1,0,2,2,2,2,0,6,-135,Home,6.5
2022-12-27,VGK,LA,1,1,0,0,2,1,1,2,0,4,-125,Home,6.5
2022-12-28,MTL,TB,0,0,1,0,1,2,1,1,0,4,-365,Home,6
2022-12-28,BOS,NJ,0,1,2,0,3,0,0,1,0,1,-115,Away,6
2022-12-28,DET,PIT,0,2,2,1,5,4,0,0,0,4,-210,Home,6.5
2022-12-28,CGY,SEA,1,1,1,0,3,1,1,0,0,2,-120,Away,6
2022-12-28,VGK,ANA,1,1,0,0,2,2,0,0,1,3,-170,Away,6
2022-12-29,DET,BUF,0,0,3,0,3,1,4,1,0,6,-190,Home,6.5
2022-12-29,MTL,FLA,2,0,0,0,2,3,1,3,0,7,-365,Home,6.5
2022-12-29,NYR,TB,1,0,0,0,1,0,0,1,1,2,-145,Home,5.5
2022-12-29,OTT,WAS,0,2,1,1,4,0,3,0,0,3,-170,Home,6
2022-12-29,CBJ,NYI,0,0,1,0,1,0,2,0,0,2,-278,Home,6.5
2022-12-29,CHI,STL,1,0,0,0,1,1,1,1,0,3,-267,Home,6
2022-12-29,DAL,MIN,1,0,3,0,4,1,0,0,0,1,-125,Home,6
2022-12-29,VAN,WPG,1,0,1,0,2,0,3,1,0,4,-145,Home,6.5
2022-12-29,LA,COL,1,1,2,1,5,0,4,0,0,4,-145,Home,6
2022-12-29,TOR,ARI,2,1,0,0,3,1,1,4,0,6,-320,Away,6
2022-12-29,PHI,SJ,1,0,2,1,4,1,1,1,0,3,-160,Home,6.5
2022-12-30,NSH,ANA,1,2,3,0,6,0,1,0,0,1,-178,Away,6
2022-12-30,NJ,PIT,0,3,1,0,4,1,1,0,0,2,0,Even,6.5
2022-12-30,FLA,CAR,0,0,0,0,0,1,2,1,0,4,-178,Home,6
2022-12-30,EDM,SEA,4,2,1,0,7,0,2,0,0,2,-135,Home,6.5
2022-12-31,BUF,BOS,1,1,1,1,4,1,0,2,0,3,-267,Home,6.5
2022-12-31,CHI,CBJ,1,0,0,0,1,1,2,1,0,4,-145,Home,6
2022-12-31,NSH,VGK,2,0,2,0,4,1,2,1,1,5,-170,Home,6
2022-12-31,MTL,WAS,0,2,0,0,2,2,3,4,0,9,-267,Home,6
2022-12-31,PHI,LA,1,1,2,0,4,2,0,0,0,2,-225,Home,6
2022-12-31,ARI,TB,2,1,0,0,3,1,3,1,0,5,-365,Home,6
2022-12-31,MIN,STL,1,2,2,0,5,1,1,0,0,2,-135,Away,5.5
2022-12-31,OTT,DET,2,0,0,0,2,0,1,3,0,4,-135,Away,6.5
2022-12-31,TOR,COL,2,3,1,0,6,1,1,0,0,2,-120,Away,6
2022-12-31,SJ,DAL,1,1,0,0,2,2,1,2,0,5,-235,Home,6
2022-12-31,VAN,CGY,0,1,1,0,2,0,3,0,0,3,-250,Home,6.5
2022-12-31,WPG,EDM,1,0,1,0,2,0,0,1,0,1,-115,Home,6.5
2023-01-01,CAR,NJ,0,2,2,1,5,0,1,3,0,4,-115,Away,6
2023-01-01,NYR,FLA,1,2,2,0,5,0,2,1,0,3,-160,Home,6.5
2023-01-01,BUF,OTT,0,1,0,0,1,1,1,1,0,3,-130,Home,6.5
2023-01-01,SJ,CHI,0,3,2,0,5,0,2,0,0,2,-145,Away,6
2023-01-01,NYI,SEA,1,0,0,0,1,1,2,1,0,4,-125,Home,6
2023-01-02,PIT,BOS,0,1,0,0,1,0,0,2,0,2,-180,Home,6
2023-01-02,VGK,COL,1,2,0,0,3,1,0,1,0,2,-160,Home,6
2023-01-02,PHI,ANA,2,1,1,0,4,0,0,1,0,1,-120,Away,6
2023-01-03,ARI,FLA,1,2,0,0,3,2,3,0,0,5,-355,Home,6.5
2023-01-03,BUF,WAS,2,1,1,1,5,1,1,2,0,4,-165,Home,6.5
2023-01-03,CAR,NYR,2,1,0,0,3,1,1,3,0,5,-125,Away,5.5
2023-01-03,CBJ,OTT,0,0,0,0,0,0,3,1,0,4,-225,Home,6.5
2023-01-03,STL,TOR,2,3,0,1,6,1,3,1,0,5,-285,Home,6
2023-01-03,CGY,WPG,0,1,1,0,2,0,1,2,0,3,-145,Away,6
2023-01-03,MTL,NSH,1,1,1,0,3,3,2,1,0,6,-260,Home,6
2023-01-03,TB,CHI,1,0,3,0,4,1,0,0,0,1,-355,Away,6.5
2023-01-03,SEA,EDM,0,4,1,0,5,1,1,0,0,2,-175,Home,6.5
2023-01-03,DAL,LA,0,2,0,0,2,1,1,1,0,3,-125,Away,6
2023-01-03,NYI,VAN,0,3,3,0,6,1,1,0,0,2,0,Even,6
2023-01-04,NJ,DET,0,2,3,0,5,0,0,1,0,1,-160,Away,6.5
2023-01-04,TB,MIN,0,1,0,0,1,1,3,1,0,5,-120,Home,6
2023-01-04,DAL,ANA,0,0,0,0,0,2,0,0,0,2,-225,Away,6
2023-01-05,ARI,PHI,1,1,0,0,2,0,5,1,0,6,-155,Home,6
2023-01-05,NSH,CAR,1,2,2,0,5,1,2,0,0,3,-235,Home,6
2023-01-05,NYR,MTL,0,3,1,0,4,0,0,1,0,1,-205,Away,6
2023-01-05,SEA,TOR,0,4,1,0,5,0,1,0,0,1,-235,Home,6.5
2023-01-05,STL,NJ,1,1,3,0,5,0,2,1,0,3,-190,Home,6.5
2023-01-05,WAS,CBJ,0,4,2,0,6,1,1,0,0,2,-220,Away,6.5
2023-01-05,NYI,EDM,0,2,0,0,2,2,2,0,0,4,-160,Home,6
2023-01-05,COL,VAN,1,1,0,0,2,0,3,1,0,4,-160,Away,6.5
2023-01-05,PIT,VGK,0,0,2,0,2,3,1,1,0,5,-115,Home,6
2023-01-05,BOS,LA,0,2,3,0,5,1,1,0,0,2,-155,Away,6
2023-01-06,FLA,DET,1,1,1,0,3,1,0,1,0,2,-160,Away,6.5
2023-01-06,NSH,WAS,2,0,1,0,3,1,1,0,0,2,-170,Home,6
2023-01-06,TB,WPG,1,1,0,0,2,1,1,2,0,4,0,Even,6
2023-01-06,ARI,CHI,0,0,0,0,0,0,1,1,0,2,0,Even,6
2023-01-06,NYI,CGY,1,0,0,0,1,3,0,1,0,4,-235,Home,5.5
2023-01-06,SJ,ANA,2,2,0,0,4,2,1,1,1,5,-170,Away,6.5
2023-01-07,NYR,NJ,1,2,0,0,3,0,1,2,1,4,-120,Home,6
2023-01-07,CAR,CBJ,0,3,0,0,3,0,2,1,1,4,-365,Away,6.5
2023-01-07,DET,TOR,1,0,0,0,1,0,2,2,0,4,-355,Home,6.5
2023-01-07,MIN,BUF,0,3,2,0,5,1,3,1,1,6,-125,Away,6.5
2023-01-07,SEA,OTT,3,2,3,0,8,1,2,1,0,4,-115,Home,6
2023-01-07,STL,MTL,1,1,2,0,4,0,2,3,0,5,-160,Away,6
2023-01-07,COL,EDM,0,0,2,1,3,1,1,0,0,2,-130,Home,6.5
2023-01-07,LA,VGK,1,2,2,0,5,0,0,1,0,1,-165,Home,6
2023-01-07,BOS,SJ,2,1,1,0,4,1,1,0,0,2,-250,Away,6.5
2023-01-08,VAN,WPG,2,2,0,0,4,2,3,2,0,7,-170,Home,6.5
2023-01-08,FLA,DAL,0,1,0,0,1,1,2,2,0,5,-130,Home,6.5
2023-01-08,CBJ,WAS,0,0,0,0,0,1,0,0,0,1,-365,Home,6.5
2023-01-08,CGY,CHI,1,2,0,0,3,2,1,0,1,4,-365,Away,5.5
2023-01-08,PIT,ARI,0,2,2,0,4,1,0,0,0,1,-235,Away,6.5
2023-01-08,STL,MIN,1,0,2,0,3,0,0,0,0,0,-220,Home,6.5
2023-01-08,TOR,PHI,2,3,1,0,6,1,1,0,0,2,-220,Away,6
2023-01-08,BOS,ANA,2,2,3,0,7,1,0,0,0,1,-320,Away,6
2023-01-09,PHI,BUF,3,0,1,0,4,0,0,0,0,0,-235,Home,6.5
2023-01-09,NSH,OTT,2,0,1,0,3,0,0,0,0,0,-120,Home,6
2023-01-09,SEA,MTL,3,0,1,0,4,0,0,0,0,0,-210,Away,6
2023-01-09,EDM,LA,1,1,1,0,3,2,2,2,0,6,0,Even,6.5
2023-01-10,CBJ,TB,0,1,2,0,3,2,1,3,0,6,-455,Home,6
2023-01-10,MIN,NYR,2,0,1,0,3,0,2,1,1,4,-140,Home,6
2023-01-10,NJ,CAR,1,2,2,0,5,1,2,0,0,3,-155,Home,6
2023-01-10,SEA,BUF,1,1,2,0,4,1,1,1,0,3,-115,Home,6.5
2023-01-10,VAN,PIT,3,0,1,0,4,3,2,0,0,5,-190,Home,6.5
2023-01-10,WPG,DET,1,2,2,0,5,3,2,2,0,7,-135,Away,6
2023-01-10,DAL,NYI,1,0,0,1,2,1,0,0,0,1,-115,Away,5.5
2023-01-10,CGY,STL,2,1,0,0,3,1,0,2,1,4,-170,Away,6
2023-01-10,SJ,ARI,1,1,2,0,4,2,0,0,0,2,-140,Away,6.5
2023-01-10,FLA,COL,3,1,1,0,5,1,0,3,0,4,-130,Home,6
2023-01-11,WAS,PHI,1,0,2,0,3,2,0,3,0,5,-190,Away,6
2023-01-11,NSH,TOR,0,1,0,0,1,1,0,1,0,2,-178,Home,6
2023-01-11,EDM,ANA,4,2,0,0,6,1,0,1,0,2,-250,Away,6.5
2023-01-11,SJ,LA,0,1,2,0,3,1,1,2,0,4,-210,Home,6.5
2023-01-12,CAR,CBJ,2,1,3,0,6,1,0,1,0,2,-350,Away,6.5
2023-01-12,DAL,NYR,0,1,0,0,1,0,0,1,1,2,-130,Home,5.5
2023-01-12,NSH,MTL,1,1,1,0,3,2,1,1,0,4,-178,Away,6.5
2023-01-12,SEA,BOS,1,1,1,0,3,0,0,0,0,0,-235,Home,6
2023-01-12,TOR,DET,0,1,0,0,1,1,1,2,0,4,-140,Away,6.5
2023-01-12,VAN,TB,1,1,2,0,4,1,3,1,0,5,-267,Home,6.5
2023-01-12,WPG,BUF,1,1,2,0,4,0,1,1,0,2,-120,Away,6.5
2023-01-12,MIN,NYI,0,0,3,0,3,1,0,0,0,1,-115,Away,5.5
2023-01-12,CGY,STL,0,1,3,0,4,0,0,1,0,1,-170,Away,6
2023-01-12,COL,CHI,1,1,0,0,2,1,1,1,0,3,-335,Away,6
2023-01-12,OTT,ARI,2,1,2,0,5,0,1,2,0,3,-160,Away,6.5
2023-01-12,FLA,VGK,1,1,0,0,2,0,1,3,0,4,-115,Home,6.5
2023-01-13,WPG,PIT,1,2,1,0,4,1,0,0,0,1,-165,Home,6.5
2023-01-13,NJ,ANA,3,1,2,0,6,0,1,1,0,2,-350,Away,6.5
2023-01-13,EDM,SJ,2,3,2,0,7,0,0,1,0,1,-165,Away,7
2023-01-14,CGY,DAL,2,4,0,0,6,1,1,3,0,5,-115,Home,6
2023-01-14,CBJ,DET,3,1,0,0,4,0,0,3,0,3,-240,Home,6.5
2023-01-14,MTL,NYI,0,0,1,0,1,2,0,0,0,2,-240,Home,5.5
2023-01-14,OTT,COL,0,0,0,0,0,2,2,3,0,7,-170,Home,6
2023-01-14,PHI,WAS,1,2,0,0,3,1,0,0,0,1,-220,Home,6
2023-01-14,PIT,CAR,0,0,1,0,1,1,1,0,0,2,-220,Home,6
2023-01-14,TOR,BOS,1,1,1,0,3,1,2,1,0,4,-155,Home,6
2023-01-14,VAN,FLA,1,1,1,0,3,1,3,0,0,4,-210,Home,7
2023-01-14,ARI,MIN,0,0,1,0,1,0,2,0,0,2,-385,Home,6
2023-01-14,BUF,NSH,1,2,2,0,5,1,2,0,0,3,-130,Home,6.5
2023-01-14,SEA,CHI,6,0,2,0,8,1,1,3,0,5,-235,Away,6
2023-01-14,TB,STL,2,2,0,0,4,1,1,0,0,2,-195,Away,6
2023-01-14,EDM,VGK,2,2,0,0,4,1,2,0,0,3,-135,Home,6.5
2023-01-14,NJ,LA,1,3,1,0,5,1,1,0,0,2,-120,Home,6.5
2023-01-15,MTL,NYR,0,1,1,0,2,0,1,0,0,1,-400,Home,6
2023-01-15,VAN,CAR,0,1,2,1,4,2,0,1,0,3,-285,Home,6.5
2023-01-15,ARI,WPG,0,1,0,0,1,0,2,0,0,2,-385,Home,6
2023-01-16,FLA,BUF,1,1,2,0,4,0,0,1,0,1,-125,Away,7
2023-01-16,PHI,BOS,0,0,0,0,0,2,2,2,0,6,-320,Home,6
2023-01-16,DET,COL,0,1,2,0,3,2,3,1,0,6,-195,Home,6.5
2023-01-16,NJ,SJ,1,0,2,1,4,2,0,1,0,3,-195,Away,6.5
2023-01-16,TB,SEA,1,0,3,0,4,0,0,1,0,1,-145,Away,6.5
2023-01-16,DAL,VGK,1,1,2,0,4,0,0,0,0,0,-115,Home,6
2023-01-16,ANA,PIT,1,0,2,0,3,1,1,1,1,4,-335,Home,6.5
2023-01-16,NYR,CBJ,2,1,0,0,3,0,0,1,0,1,-170,Away,6.5
2023-01-16,WAS,NYI,0,2,1,1,4,2,1,0,0,3,0,Even,5.5
2023-01-16,CGY,NSH,0,1,0,0,1,2,0,0,0,2,-135,Away,6
2023-01-16,OTT,STL,0,1,0,0,1,2,0,0,0,2,-115,Away,6.5
2023-01-17,ANA,PHI,0,1,1,0,2,1,2,2,0,5,-210,Home,6
2023-01-17,FLA,TOR,3,1,0,0,4,2,1,1,1,5,-178,Home,6.5
2023-01-17,MIN,WAS,0,3,1,0,4,1,1,0,0,2,-145,Away,6
2023-01-17,WPG,MTL,0,1,0,0,1,0,3,1,0,4,-260,Away,6
2023-01-17,CBJ,NSH,0,0,1,0,1,0,2,0,0,2,-210,Home,6.5
2023-01-17,BUF,CHI,2,1,0,0,3,1,0,2,1,4,-205,Away,6.5
2023-01-17,DET,ARI,0,1,2,0,3,0,1,2,1,4,-135,Away,6
2023-01-17,SEA,EDM,1,0,1,0,2,1,2,2,0,5,-190,Home,6.5
2023-01-18,PIT,OTT,2,1,1,0,4,2,1,1,1,5,-115,Home,6
2023-01-18,BOS,NYI,0,2,2,0,4,1,0,0,0,1,-190,Away,5.5
2023-01-18,COL,CGY,3,0,1,0,4,0,0,1,0,1,-155,Home,6
2023-01-18,DAL,SJ,1,2,0,0,3,0,3,2,0,5,-160,Away,6
2023-01-18,TB,VAN,4,0,1,0,5,0,0,2,0,2,-150,Away,6.5
2023-01-19,ANA,CBJ,0,3,2,0,5,3,0,0,0,3,-170,Home,6.5
2023-01-19,BOS,NYR,1,1,1,0,3,0,0,1,0,1,0,Even,5.5
2023-01-19,CHI,PHI,0,2,2,0,4,1,0,0,0,1,-235,Home,6
2023-01-19,FLA,MTL,0,5,1,0,6,0,0,2,0,2,-240,Away,6.5
2023-01-19,MIN,CAR,0,1,1,0,2,0,3,2,0,5,-178,Home,5.5
2023-01-19,WPG,TOR,0,0,1,0,1,0,3,1,0,4,-170,Home,6.5
2023-01-19,NYI,BUF,1,1,0,0,2,0,1,1,1,3,-125,Home,6
2023-01-19,NSH,STL,0,1,1,0,2,0,3,2,0,5,-120,Away,6
2023-01-19,TB,EDM,0,3,0,0,3,2,1,2,0,5,-125,Home,6.5
2023-01-19,WAS,ARI,1,2,1,0,4,0,0,0,0,0,-225,Away,6
2023-01-19,DET,VGK,1,2,0,0,3,1,0,1,0,2,-170,Home,6.5
2023-01-19,NJ,SEA,0,1,2,0,3,1,1,1,1,4,-135,Away,6.5
2023-01-19,DAL,LA,3,1,0,0,4,0,0,0,0,0,-140,Home,6
2023-01-20,OTT,PIT,0,1,0,0,1,2,1,1,0,4,-165,Home,6.5
2023-01-20,COL,VAN,1,3,0,0,4,0,1,0,0,1,-155,Away,6.5
2023-01-21,ANA,BUF,0,3,0,0,3,2,1,3,0,6,-292,Home,6.5
2023-01-21,TB,CGY,0,2,1,0,3,1,2,3,0,6,-115,Home,6
2023-01-21,MIN,FLA,0,1,2,0,3,1,2,2,0,5,-115,Home,6.5
2023-01-21,PHI,DET,0,0,2,0,2,0,0,1,0,1,-140,Home,6
2023-01-21,SJ,CBJ,1,1,1,0,3,0,2,3,0,5,-135,Away,6.5
2023-01-21,TOR,MTL,2,0,0,0,2,0,2,0,1,3,-385,Away,6.5
2023-01-21,WPG,OTT,1,2,2,0,5,1,0,0,0,1,-135,Away,6
2023-01-21,CAR,NYI,2,1,2,0,5,2,0,0,0,2,-178,Away,5.5
2023-01-21,ARI,DAL,0,0,0,0,0,3,1,0,0,4,-355,Home,6
2023-01-21,CHI,STL,2,2,1,0,5,0,2,1,0,3,-278,Home,6
2023-01-21,LA,NSH,1,2,0,0,3,2,0,3,0,5,-115,Home,6
2023-01-21,COL,SEA,0,1,0,1,2,0,1,0,0,1,0,Even,6
2023-01-21,EDM,VAN,2,1,1,0,4,0,1,1,0,2,-195,Away,7
2023-01-21,WAS,VGK,0,1,1,0,2,2,3,1,0,6,-135,Home,6
2023-01-22,PIT,NJ,1,0,0,0,1,1,0,0,1,2,-145,Home,6.5
2023-01-22,LA,CHI,1,1,0,0,2,0,0,1,0,1,-235,Away,6
2023-01-22,SJ,BOS,0,0,0,0,0,1,2,1,0,4,-385,Home,6
2023-01-22,WPG,PHI,3,0,2,0,5,1,1,1,0,3,-165,Away,6.5
2023-01-22,VGK,ARI,0,1,0,0,1,1,1,2,0,4,-220,Away,6
2023-01-23,FLA,NYR,1,0,1,0,2,2,1,3,0,6,-160,Home,6.5
2023-01-23,NYI,TOR,1,1,0,0,2,0,4,1,0,5,-235,Home,6
2023-01-23,BUF,DAL,1,0,1,1,3,1,0,1,0,2,-190,Home,6.5
2023-01-23,CBJ,CGY,0,2,1,0,3,1,2,0,1,4,-365,Home,6.5
2023-01-24,BOS,MTL,0,1,3,0,4,0,1,1,0,2,-420,Away,6
2023-01-24,FLA,PIT,3,1,2,0,6,3,1,2,1,7,-165,Home,6.5
2023-01-24,LA,PHI,2,1,0,1,4,2,1,0,0,3,-130,Away,6
2023-01-24,MIN,TB,0,2,0,0,2,0,2,2,0,4,-165,Home,6
2023-01-24,SJ,DET,0,2,0,0,2,0,2,0,1,3,-145,Home,6.5
2023-01-24,VGK,NJ,0,2,0,0,2,1,0,1,1,3,-178,Home,6.5
2023-01-24,BUF,STL,3,1,1,0,5,0,2,1,0,3,-135,Home,6.5
2023-01-24,WPG,NSH,1,0,0,0,1,0,1,1,0,2,-120,Away,5.5
2023-01-24,ANA,ARI,1,2,2,0,5,0,0,2,0,2,-125,Home,6.5
2023-01-24,WAS,COL,0,1,1,0,2,1,2,0,0,3,-130,Home,6
2023-01-24,CHI,VAN,1,1,0,0,2,0,2,3,0,5,-260,Home,6.5
2023-01-25,NYI,OTT,0,1,0,0,1,1,1,0,0,2,-130,Home,6
2023-01-25,NYR,TOR,0,2,0,0,2,1,0,1,1,3,-160,Home,6
2023-01-25,CAR,DAL,1,1,0,1,3,2,0,0,0,2,-115,Away,6
2023-01-25,CBJ,EDM,1,0,1,1,3,0,2,0,0,2,-400,Home,6.5
2023-01-25,VAN,SEA,0,1,0,0,1,2,3,1,0,6,-178,Home,6.5
2023-01-26,BOS,TB,0,1,1,0,2,1,0,2,0,3,-115,Home,6
2023-01-26,DET,MTL,1,2,0,1,4,1,2,0,0,3,-170,Away,6
2023-01-26,PIT,WAS,0,1,1,0,2,1,0,1,1,3,-130,Home,6.5
2023-01-26,BUF,WPG,0,2,1,0,3,0,0,2,0,2,-190,Home,6.5
2023-01-26,NJ,NSH,2,1,1,0,4,2,1,3,0,6,-120,Away,6
2023-01-26,PHI,MIN,1,0,1,0,2,0,1,1,1,3,-235,Home,6
2023-01-26,ANA,COL,1,1,3,0,5,1,2,0,0,3,-420,Home,6.5
2023-01-26,CHI,CGY,1,3,1,0,5,1,0,0,0,1,-400,Home,6
2023-01-26,STL,ARI,0,0,0,0,0,0,2,3,0,5,-150,Away,6.5
2023-01-27,DET,NYI,0,0,0,0,0,0,1,1,0,2,-190,Home,5.5
2023-01-27,LA,FLA,2,1,1,0,4,0,2,1,0,3,-140,Home,6.5
2023-01-27,VGK,NYR,0,1,0,0,1,2,0,2,0,4,-135,Home,6
2023-01-27,OTT,TOR,1,3,2,0,6,1,1,0,0,2,-205,Home,6.5
2023-01-27,SJ,CAR,1,0,3,0,4,1,0,3,1,5,-278,Home,6
2023-01-27,NJ,DAL,0,2,0,1,3,2,0,0,0,2,-160,Home,6
2023-01-27,CGY,SEA,3,0,2,0,5,1,0,1,0,2,-115,Home,6
2023-01-27,CBJ,VAN,1,0,1,0,2,3,0,2,0,5,-180,Home,7
2023-01-28,STL,COL,0,1,1,0,2,2,1,1,0,4,-225,Home,6
2023-01-28,BOS,FLA,1,1,1,0,3,0,1,2,1,4,-160,Away,6.5
2023-01-28,LA,TB,1,1,0,0,2,3,1,1,0,5,-240,Home,6
2023-01-28,MTL,OTT,0,0,0,0,0,0,3,2,0,5,-240,Home,6.5
2023-01-28,PHI,WPG,1,1,2,0,4,0,0,0,0,0,-225,Home,6
2023-01-28,SJ,PIT,2,2,2,0,6,2,1,1,0,4,-250,Home,6.5
2023-01-28,VGK,NYI,0,1,0,0,1,0,1,0,1,2,-115,Away,6
2023-01-28,BUF,MIN,1,1,0,0,2,1,1,0,1,3,-178,Home,6.5
2023-01-28,CHI,EDM,0,1,2,0,3,1,4,2,0,7,-455,Home,6.5
2023-01-28,CBJ,SEA,0,1,0,0,1,1,1,1,0,3,-267,Home,6.5
2023-01-28,ARI,ANA,1,0,0,0,1,0,1,0,1,2,-115,Home,6.5
2023-01-29,BOS,CAR,0,0,1,0,1,1,1,2,0,4,-125,Home,5.5
2023-01-29,WAS,TOR,1,0,0,0,1,0,4,1,0,5,-140,Home,6
2023-01-30,STL,WPG,0,1,1,0,2,0,0,4,0,4,-235,Home,6
2023-01-31,LA,CAR,0,4,0,0,4,1,0,3,1,5,-210,Home,6
2023-01-31,OTT,MTL,2,1,2,0,5,1,1,2,0,4,-205,Away,6.5
2023-01-31,WAS,CBJ,2,1,0,1,4,1,1,1,0,3,-220,Away,6.5
2023-02-01,BOS,TOR,0,2,3,0,5,0,1,1,0,2,-130,Away,5.5
2023-02-01,CAR,BUF,3,0,2,0,5,1,0,0,0,1,-145,Away,6.5
2023-02-06,NYI,PHI,1,1,0,0,2,0,1,0,0,1,-130,Away,5.5
2023-02-06,TB,FLA,0,1,0,0,1,1,3,3,0,7,-120,Away,6.5
2023-02-06,CGY,NYR,1,1,2,0,4,1,2,1,1,5,0,Even,5.5
2023-02-06,VAN,NJ,1,2,1,0,4,1,3,0,1,5,-250,Home,6.5
2023-02-06,ANA,DAL,0,0,2,0,2,1,1,0,1,3,-420,Home,6
2023-02-06,MIN,ARI,0,1,1,0,2,0,1,2,0,3,-250,Away,6
2023-02-07,COL,PIT,0,1,0,0,1,0,0,1,1,2,-115,Away,6.5
2023-02-07,SJ,TB,1,1,1,1,4,3,0,0,0,3,-225,Home,6.5
2023-02-07,EDM,DET,0,3,2,0,5,1,1,0,0,2,-170,Away,6.5
2023-02-07,SEA,NYI,0,0,0,0,0,2,2,0,0,4,-125,Home,5.5
2023-02-07,VGK,NSH,3,1,1,0,5,1,0,0,0,1,-115,Home,6
2023-02-07,ANA,CHI,0,2,0,1,3,0,2,0,0,2,-125,Home,6.5
2023-02-08,VAN,NYR,1,1,1,0,3,2,1,1,0,4,-250,Home,6.5
2023-02-08,MIN,DAL,0,1,0,0,1,0,3,1,0,4,-160,Home,5.5
2023-02-09,CGY,DET,0,1,0,0,1,0,1,1,0,2,-160,Away,6
2023-02-09,COL,TB,0,0,0,0,0,1,3,1,0,5,-145,Home,6
2023-02-09,EDM,PHI,0,1,0,0,1,1,0,0,1,2,-195,Away,6.5
2023-02-09,SEA,NJ,0,1,0,0,1,0,1,2,0,3,-125,Home,6.5
2023-02-09,SJ,FLA,1,0,0,0,1,0,2,2,0,4,-220,Home,6.5
2023-02-09,VAN,NYI,2,1,3,0,6,2,2,1,0,5,-225,Home,6.5
2023-02-09,VGK,MIN,1,4,0,0,5,0,1,0,0,1,-115,Home,5.5
2023-02-10,SEA,NYR,0,1,2,0,3,3,1,2,0,6,-195,Home,6
2023-02-10,TOR,CBJ,1,0,2,0,3,0,0,0,0,0,-260,Away,6.5
2023-02-10,ARI,CHI,2,0,1,0,3,1,1,1,1,4,-115,Home,6
2023-02-10,PIT,ANA,3,1,2,0,6,1,0,2,0,3,-267,Away,6.5
2023-02-11,VAN,DET,0,1,1,0,2,2,1,2,0,5,-130,Home,6.5
2023-02-11,CGY,BUF,0,4,3,0,7,2,0,0,0,2,-145,Away,6.5
2023-02-11,EDM,OTT,1,2,3,0,6,0,3,0,0,3,-145,Away,6.5
2023-02-11,NSH,PHI,0,1,0,1,2,0,1,0,0,1,-130,Away,6
2023-02-11,NYI,MTL,1,1,1,0,3,1,0,2,1,4,-210,Away,6
2023-02-11,TB,DAL,0,1,2,0,3,0,1,0,0,1,0,Even,6
2023-02-11,WAS,BOS,1,1,0,0,2,0,1,0,0,1,-190,Home,6
2023-02-11,COL,FLA,2,2,1,0,5,0,2,1,0,3,-140,Home,6.5
2023-02-11,CBJ,TOR,0,3,1,0,4,2,0,1,0,3,-365,Home,6.5
2023-02-11,NYR,CAR,1,1,4,0,6,0,2,0,0,2,-210,Home,6
2023-02-11,ARI,STL,2,0,3,0,5,0,2,3,1,6,-220,Home,6
2023-02-11,NJ,MIN,0,2,0,0,2,1,0,1,1,3,-125,Home,6
2023-02-11,CHI,WPG,0,0,1,0,1,0,3,1,0,4,-385,Home,6
2023-02-11,PIT,LA,0,0,0,0,0,2,3,1,0,6,-120,Home,6.5
2023-02-12,EDM,MTL,0,2,0,0,2,1,3,2,0,6,-278,Away,6.5
2023-02-12,SEA,PHI,2,1,1,0,4,1,1,1,0,3,-160,Away,6.5
2023-02-12,SJ,WAS,1,1,2,0,4,0,1,0,0,1,-178,Home,6.5
2023-02-12,ANA,VGK,0,1,1,0,2,1,1,5,0,7,-365,Home,6.5
2023-02-13,CGY,OTT,1,1,1,0,3,1,0,2,1,4,-170,Away,6.5
2023-02-13,ARI,NSH,1,1,2,0,4,0,2,0,0,2,-240,Home,6
2023-02-13,FLA,MIN,0,1,0,1,2,0,1,0,0,1,0,Even,6.5
2023-02-13,DET,VAN,2,1,3,0,6,0,1,0,0,1,-120,Home,6.5
2023-02-13,BUF,LA,0,0,2,0,2,0,4,1,0,5,-135,Home,6.5
2023-02-14,CAR,WAS,1,2,0,0,3,1,1,0,0,2,-170,Away,5.5
2023-02-14,CHI,MTL,0,0,0,0,0,1,0,3,0,4,-140,Home,6
2023-02-14,NJ,CBJ,1,1,1,0,3,1,1,0,0,2,-210,Away,6.5
2023-02-14,OTT,NYI,0,1,1,1,3,0,1,1,0,2,-205,Home,6
2023-02-14,FLA,STL,0,1,1,0,2,1,2,3,0,6,-135,Away,6.5
2023-02-14,SEA,WPG,0,2,0,0,2,0,1,1,1,3,-135,Home,6
2023-02-14,BOS,DAL,1,0,1,1,3,1,1,0,0,2,-125,Away,5.5
2023-02-14,TB,COL,0,1,2,1,4,1,1,1,0,3,-125,Away,6
2023-02-14,PIT,SJ,1,1,1,0,3,0,0,1,0,1,-175,Away,6.5
2023-02-15,CHI,TOR,1,1,0,0,2,3,2,0,0,5,-650,Home,6.5
2023-02-15,TB,ARI,0,0,0,0,0,0,0,0,1,1,-250,Away,6.5
2023-02-15,COL,MIN,1,2,0,0,3,0,1,1,0,2,-125,Home,6
2023-02-15,DET,EDM,2,2,0,1,5,0,2,2,0,4,-250,Home,6.5
2023-02-15,BUF,ANA,2,2,3,0,7,0,3,0,0,3,-205,Away,6.5
2023-02-15,NYR,VAN,3,2,1,0,6,2,1,1,0,4,-180,Away,6.5
2023-02-16,FLA,WAS,1,3,2,0,6,0,1,2,0,3,-125,Away,6.5
2023-02-16,MTL,CAR,1,1,0,0,2,2,0,4,0,6,-455,Home,6
2023-02-16,WPG,CBJ,1,0,0,0,1,0,1,2,0,3,-190,Away,6
2023-02-16,BOS,NSH,1,3,1,0,5,0,0,0,0,0,-190,Away,5.5
2023-02-16,DET,CGY,1,3,1,0,5,1,1,0,0,2,-285,Home,6.5
2023-02-16,NJ,STL,1,1,0,0,2,1,2,1,0,4,-155,Away,6
2023-02-16,PHI,SEA,0,0,2,0,2,2,3,1,0,6,-190,Home,6
2023-02-16,SJ,VGK,0,1,0,0,1,0,0,2,0,2,-180,Home,6.5
2023-02-17,CHI,OTT,1,0,2,1,4,0,1,2,0,3,-267,Home,6.5
2023-02-17,PIT,NYI,1,3,0,0,4,1,2,2,0,5,-130,Home,5.5
2023-02-17,DAL,MIN,0,0,1,0,1,0,0,1,1,2,-115,Away,5.5
2023-02-17,LA,ANA,1,2,3,0,6,0,1,2,0,3,-278,Away,6.5
2023-02-17,NYR,EDM,1,1,2,1,5,4,0,0,0,4,-125,Home,7
2023-02-18,COL,STL,1,1,2,0,4,0,1,0,0,1,-195,Away,6.5
2023-02-18,FLA,NSH,2,0,1,0,3,3,2,2,0,7,-150,Away,6.5
2023-02-18,NYI,BOS,0,1,1,0,2,3,3,0,0,6,-267,Home,5.5
2023-02-18,NJ,PIT,1,2,2,0,5,1,0,1,0,2,-135,Away,6.5
2023-02-18,CBJ,DAL,1,0,3,0,4,0,1,0,0,1,-292,Home,6
2023-02-18,MTL,TOR,0,1,0,0,1,0,3,2,0,5,-455,Home,6.5
2023-02-18,WAS,CAR,0,0,1,0,1,1,3,0,0,4,-190,Home,5.5
2023-02-18,NYR,CGY,0,1,1,0,2,2,0,0,1,3,-160,Home,6.5
2023-02-18,PHI,VAN,1,1,0,0,2,1,2,3,0,6,-120,Home,6.5
2023-02-18,ARI,LA,1,1,3,0,5,5,0,0,1,6,-235,Home,6.5
2023-02-18,BUF,SJ,1,1,2,0,4,1,1,0,0,2,-120,Away,7
2023-02-18,DET,SEA,1,0,1,0,2,1,2,1,0,4,-178,Home,6
2023-02-18,TB,VGK,2,1,1,0,4,4,0,1,0,5,-130,Away,6
2023-02-19,NSH,MIN,0,1,2,0,3,0,2,2,0,4,-190,Home,5.5
2023-02-19,STL,OTT,0,0,2,0,2,1,4,2,0,7,-180,Home,6.5
2023-02-19,EDM,COL,1,3,1,0,5,0,2,3,1,6,-120,Away,6.5
2023-02-19,TOR,CHI,1,1,1,0,3,1,2,2,0,5,-335,Away,6.5
2023-02-19,WPG,NJ,2,0,0,0,2,1,0,3,0,4,-120,Home,6
2023-02-19,CBJ,ARI,0,1,1,0,2,2,0,0,1,3,-130,Home,6.5
2023-02-20,ANA,FLA,2,0,1,0,3,0,2,1,1,4,-430,Home,7
2023-02-20,OTT,BOS,1,0,0,0,1,1,1,1,0,3,-365,Home,6.5
2023-02-20,PHI,CGY,1,2,1,0,4,0,1,2,0,3,-250,Home,6
2023-02-20,SEA,SJ,0,0,0,0,0,0,3,1,0,4,-165,Away,6.5
2023-02-20,NYI,PIT,0,1,3,0,4,1,1,0,0,2,-165,Home,6
2023-02-20,WPG,NYR,2,1,1,0,4,0,1,0,0,1,-170,Home,6
2023-02-21,ANA,TB,0,0,1,0,1,0,4,2,0,6,-600,Home,6.5
2023-02-21,DET,WAS,2,0,1,0,3,1,0,0,0,1,-160,Home,6
2023-02-21,MTL,NJ,1,2,2,0,5,1,0,1,0,2,-365,Home,6.5
2023-02-21,STL,CAR,0,1,0,0,1,2,1,1,0,4,-365,Home,6
2023-02-21,TOR,BUF,4,1,1,0,6,0,0,3,0,3,-170,Away,6.5
2023-02-21,LA,MIN,0,0,1,0,1,0,1,1,0,2,-125,Home,6
2023-02-21,VAN,NSH,0,2,2,0,4,1,2,1,1,5,-160,Home,6.5
2023-02-21,VGK,CHI,1,1,0,0,2,1,0,1,1,3,-267,Away,6.5
2023-02-21,PHI,EDM,1,1,0,0,2,1,0,3,0,4,-335,Home,7
2023-02-22,WPG,NYI,0,1,0,0,1,1,0,1,0,2,0,Even,5.5
2023-02-22,CGY,ARI,1,2,3,0,6,0,3,0,0,3,-250,Away,6
2023-02-22,CHI,DAL,0,3,1,0,4,2,1,0,0,3,-455,Home,6
2023-02-23,ANA,WAS,0,2,2,0,4,1,1,0,0,2,-345,Home,6
2023-02-23,BUF,TB,1,3,1,1,6,1,1,3,0,5,-225,Home,7
2023-02-23,EDM,PIT,2,4,1,0,7,1,0,1,0,2,0,Even,7
2023-02-23,LA,NJ,2,0,1,0,3,0,1,2,1,4,-145,Home,6.5
2023-02-23,MIN,CBJ,2,0,0,0,2,0,0,0,0,0,-190,Away,6
2023-02-23,NYR,DET,0,1,0,0,1,1,2,1,0,4,-155,Away,6.5
2023-02-23,VAN,STL,0,0,2,1,3,1,1,0,0,2,-120,Home,6.5
2023-02-23,CGY,VGK,1,2,0,0,3,0,1,2,1,4,-135,Home,6.5
2023-02-23,BOS,SEA,1,3,2,0,6,1,3,1,0,5,-178,Away,6
2023-02-23,NSH,SJ,1,3,2,0,6,0,1,1,0,2,-120,Away,6
2023-02-24,BUF,FLA,0,2,1,0,3,0,0,1,0,1,-195,Home,7
2023-02-24,MIN,TOR,1,0,0,0,1,1,0,0,1,2,-220,Home,6
2023-02-24,MTL,PHI,2,1,2,0,5,0,0,2,0,2,-165,Home,6
2023-02-24,OTT,CAR,0,0,0,0,0,2,0,2,0,4,-250,Home,6.5
2023-02-24,LA,NYI,0,3,0,0,3,0,1,1,0,2,-140,Home,5.5
2023-02-24,COL,WPG,4,1,0,0,5,1,0,0,0,1,-120,Home,5.5
2023-02-25,EDM,CBJ,0,4,1,0,5,1,3,2,0,6,-260,Away,7
2023-02-25,NYR,WAS,1,0,2,0,3,1,4,1,0,6,-140,Away,6
2023-02-25,PIT,STL,0,1,1,1,3,0,1,1,0,2,-170,Away,6.5
2023-02-25,ANA,CAR,0,1,2,0,3,0,0,2,0,2,-550,Home,6.5
2023-02-25,BOS,VAN,2,0,1,0,3,0,0,1,0,1,-278,Away,6.5
2023-02-25,OTT,MTL,1,1,3,0,5,0,2,0,0,2,-170,Away,6.5
2023-02-25,PHI,NJ,0,0,0,0,0,0,3,4,0,7,-320,Home,6
2023-02-25,TB,DET,1,1,1,0,3,0,0,0,0,0,-190,Away,6
2023-02-25,CGY,COL,0,1,0,0,1,2,1,1,0,4,0,Even,6
2023-02-25,CHI,SJ,2,0,1,1,4,2,0,1,0,3,-225,Home,6
2023-02-25,DAL,VGK,0,1,1,1,3,0,1,1,0,2,-120,Home,5.5
2023-02-26,WAS,BUF,2,2,0,0,4,2,4,1,0,7,-120,Home,6.5
2023-02-26,CBJ,MIN,1,1,0,0,2,0,0,2,1,3,-320,Home,5.5
2023-02-26,NYI,WPG,1,2,1,0,4,0,0,0,0,0,-135,Home,5.5
2023-02-26,LA,NYR,0,1,1,0,2,1,2,2,0,5,-165,Home,6
2023-02-26,TB,PIT,2,0,1,0,3,1,6,0,0,7,-115,Home,6.5
2023-02-26,NSH,ARI,2,1,3,0,6,1,1,0,0,2,-170,Away,6
2023-02-26,TOR,SEA,3,1,1,0,5,1,0,0,0,1,-155,Away,6.5
2023-02-27,DET,OTT,1,1,0,0,2,0,4,2,0,6,-130,Home,6.5
2023-02-27,BOS,EDM,2,1,0,0,3,1,1,0,0,2,-125,Away,6.5
2023-02-27,VAN,DAL,3,1,0,1,5,1,2,1,0,4,-285,Home,6
2023-02-27,VGK,COL,0,0,0,0,0,1,1,1,0,3,-155,Home,6
2023-02-27,CHI,ANA,1,1,0,0,2,2,1,1,0,4,-125,Home,6
2023-02-28,DET,OTT,1,0,0,0,1,4,1,1,0,6,-140,Home,6.5
2023-02-28,FLA,TB,3,0,1,0,4,0,1,0,0,1,-170,Home,6.5
2023-02-28,CBJ,BUF,2,2,1,0,5,1,0,2,0,3,-205,Home,6.5
2023-02-28,LA,WPG,0,3,2,1,6,2,3,0,0,5,-135,Home,6
2023-02-28,NYI,MIN,1,0,0,0,1,1,0,0,1,2,-140,Home,5.5
2023-02-28,PIT,NSH,0,0,3,0,3,0,0,1,0,1,-140,Away,6
2023-02-28,SEA,STL,1,2,2,0,5,0,2,1,0,3,-160,Away,6
2023-02-28,BOS,CGY,2,0,1,1,4,0,1,2,0,3,-130,Away,6
2023-02-28,CHI,ARI,0,0,1,0,1,2,1,1,0,4,-190,Home,6
2023-02-28,MTL,SJ,0,0,3,0,3,1,0,0,0,1,-165,Home,6.5
2023-03-01,NYR,PHI,1,0,1,1,3,1,1,0,0,2,-235,Away,6
2023-03-01,TOR,EDM,1,0,1,0,2,3,2,0,0,5,0,Even,7
2023-03-01,ARI,DAL,2,0,0,0,2,1,1,2,0,4,-430,Home,6
2023-03-01,NJ,COL,3,3,1,0,7,1,3,1,0,5,0,Even,6
2023-03-01,CAR,VGK,0,1,1,0,2,0,2,1,0,3,-160,Away,5.5
2023-03-01,WAS,ANA,1,0,1,1,3,1,0,1,0,2,-195,Away,6.5
2023-03-02,BUF,BOS,0,0,1,0,1,0,2,5,0,7,-285,Home,6.5
2023-03-02,NSH,FLA,2,0,0,0,2,0,1,0,0,1,-235,Home,7
2023-03-02,OTT,NYR,0,2,3,0,5,1,2,0,0,3,-155,Home,6.5
2023-03-02,PIT,TB,0,3,1,1,5,1,1,2,0,4,-165,Home,6.5
2023-03-02,SEA,DET,3,1,0,1,5,2,2,0,0,4,-125,Away,6.5
2023-03-02,DAL,CHI,2,0,3,0,5,1,1,0,0,2,-278,Away,6
2023-03-02,TOR,CGY,0,1,1,0,2,1,0,0,0,1,-130,Home,6.5
2023-03-02,MIN,VAN,1,1,0,0,2,1,0,0,0,1,-155,Away,6
2023-03-02,MTL,LA,1,0,1,0,2,0,1,2,0,3,-267,Home,6.5
2023-03-02,STL,SJ,0,4,2,0,6,2,0,1,0,3,-125,Home,6
2023-03-03,SEA,CBJ,0,2,2,0,4,0,1,1,0,2,-165,Away,6.5
2023-03-03,WPG,EDM,0,0,3,0,3,1,3,2,0,6,-175,Home,6.5
2023-03-03,CAR,ARI,2,3,1,0,6,0,1,0,0,1,-365,Away,6
2023-03-03,MTL,ANA,1,0,1,0,2,1,0,2,0,3,-120,Home,6
2023-03-03,NJ,VGK,2,0,1,0,3,1,1,1,1,4,-115,Away,6
2023-03-04,DET,NYI,0,1,0,0,1,0,0,4,0,4,-205,Home,5.5
2023-03-04,TB,BUF,1,0,2,0,3,1,3,1,0,5,-160,Away,7
2023-03-04,NYR,BOS,0,1,1,0,2,1,1,2,0,4,-180,Home,6
2023-03-04,COL,DAL,1,0,2,0,3,3,2,2,0,7,-120,Home,6
2023-03-04,PIT,FLA,0,1,0,0,1,1,2,1,0,4,-140,Home,6.5
2023-03-04,WAS,SJ,0,4,4,0,8,2,0,1,0,3,-155,Away,6
2023-03-04,CBJ,OTT,1,1,0,0,2,2,2,1,0,5,-292,Home,6.5
2023-03-04,EDM,WPG,1,3,1,0,5,2,4,1,0,7,-115,Away,6.5
2023-03-04,TOR,VAN,0,0,1,0,1,0,1,3,0,4,-220,Away,6.5
2023-03-04,NSH,CHI,1,1,1,0,3,1,0,0,0,1,-225,Away,5.5
2023-03-04,MIN,CGY,1,0,2,0,3,0,0,0,0,0,-160,Home,5.5
2023-03-04,STL,LA,1,0,1,0,2,1,1,2,0,4,-210,Home,6
2023-03-05,TB,CAR,0,0,0,0,0,2,2,2,0,6,-170,Home,6
2023-03-05,DET,PHI,1,0,0,0,1,0,2,1,0,3,-130,Home,6
2023-03-05,MTL,VGK,0,0,3,0,3,2,1,1,0,4,-285,Home,6
2023-03-05,NJ,ARI,2,2,0,1,5,1,1,2,0,4,-365,Away,6.5
2023-03-05,SEA,COL,0,1,1,1,3,1,1,0,0,2,-170,Home,6
2023-03-06,EDM,BUF,1,1,1,0,3,1,0,1,0,2,-165,Away,7
2023-03-06,SJ,WPG,1,0,1,1,3,0,1,1,0,2,-210,Home,6
2023-03-06,CGY,DAL,1,2,2,0,5,0,2,2,0,4,-130,Home,6
2023-03-06,OTT,CHI,0,0,0,0,0,1,3,1,0,5,-260,Away,6
2023-03-06,NSH,VAN,1,0,2,0,3,2,0,1,1,4,-115,Away,6
2023-03-06,WAS,LA,0,1,1,0,2,0,2,2,0,4,-145,Home,6.5
2023-03-07,CAR,MTL,1,1,1,1,4,2,1,0,0,3,-350,Away,6
2023-03-07,CBJ,PIT,3,1,0,0,4,0,1,3,1,5,-335,Home,6.5
2023-03-07,VGK,FLA,0,1,0,0,1,1,1,0,0,2,-175,Home,6.5
2023-03-07,PHI,TB,1,1,0,0,2,1,3,1,0,5,-305,Home,6
2023-03-07,TOR,NJ,0,1,3,0,4,0,1,2,0,3,-130,Home,6.5
2023-03-07,BUF,NYI,0,1,1,0,2,0,1,2,0,3,-170,Home,6.5
2023-03-07,CGY,MIN,0,0,0,1,1,0,0,0,0,0,-155,Home,5.5
2023-03-07,SJ,COL,0,0,0,0,0,3,3,0,0,6,-350,Home,6.5
2023-03-07,STL,ARI,1,0,1,0,2,1,1,4,0,6,-140,Away,6
2023-03-07,ANA,SEA,0,1,1,0,2,2,1,2,0,5,-305,Home,6.5
2023-03-08,CHI,DET,2,0,1,0,3,0,2,2,0,4,-250,Home,5.5
2023-03-08,MIN,WPG,1,2,1,0,4,0,2,0,0,2,-125,Home,5.5
2023-03-08,ANA,VAN,1,1,0,0,2,1,1,0,1,3,-260,Home,6.5
2023-03-09,DAL,BUF,3,2,5,0,10,1,1,2,0,4,-170,Away,6.5
2023-03-09,VGK,TB,1,0,2,1,4,1,0,2,0,3,-170,Home,6
2023-03-09,NJ,WAS,0,2,0,1,3,1,1,0,0,2,-140,Away,6.5
2023-03-09,NYI,PIT,1,0,2,1,4,2,1,0,0,3,-145,Home,6
2023-03-09,NYR,MTL,1,2,0,1,4,2,1,0,0,3,-292,Away,6.5
2023-03-09,PHI,CAR,0,0,0,0,0,1,0,0,0,1,-430,Home,6
2023-03-09,EDM,BOS,0,1,2,0,3,2,0,0,0,2,-160,Home,6.5
2023-03-09,SJ,STL,1,1,0,0,2,1,1,2,0,4,-155,Home,6.5
2023-03-09,LA,COL,2,0,3,0,5,0,1,1,0,2,-165,Home,6
2023-03-09,NSH,ARI,0,0,1,0,1,1,0,3,0,4,-190,Away,6
2023-03-09,OTT,SEA,3,0,2,0,5,1,2,1,0,4,-130,Home,6.5
2023-03-10,CHI,FLA,2,0,1,0,3,0,0,3,1,4,-480,Home,6.5
2023-03-10,ANA,CGY,0,2,1,0,3,0,1,0,0,1,-420,Home,6
2023-03-11,DET,BOS,2,0,0,0,2,0,2,1,0,3,-400,Home,6
2023-03-11,PHI,PIT,1,0,0,0,1,1,1,3,0,5,-278,Home,6.5
2023-03-11,NYR,BUF,0,1,0,1,2,0,1,0,0,1,-165,Away,6.5
2023-03-11,ARI,COL,2,0,0,0,2,1,1,0,1,3,-480,Home,6.5
2023-03-11,CHI,TB,0,0,1,0,1,0,1,2,0,3,-550,Home,6.5
2023-03-11,EDM,TOR,2,1,1,0,4,1,4,2,0,7,-125,Home,7
2023-03-11,VGK,CAR,1,1,2,0,4,0,0,0,0,0,-225,Home,6
2023-03-11,NJ,MTL,2,0,1,0,3,0,1,0,0,1,-285,Away,6.5
2023-03-11,STL,CBJ,3,0,2,0,5,1,0,1,0,2,-135,Away,6.5
2023-03-11,WPG,FLA,3,1,0,1,5,1,1,2,0,4,-135,Home,6.5
2023-03-11,WAS,NYI,2,0,3,0,5,1,0,0,0,1,-130,Home,5.5
2023-03-11,DAL,SEA,0,2,1,1,4,0,1,2,0,3,-130,Away,6
2023-03-11,OTT,VAN,0,0,2,0,2,1,2,2,0,5,-125,Away,6.5
2023-03-11,MIN,SJ,1,1,3,0,5,0,1,1,0,2,-165,Away,6
2023-03-11,NSH,LA,1,0,0,1,2,1,0,0,0,1,-190,Home,6
2023-03-12,BOS,DET,0,1,2,0,3,1,3,1,0,5,-240,Away,6
2023-03-12,NYR,PIT,1,0,1,0,2,1,1,0,1,3,-135,Home,6.5
2023-03-12,CAR,NJ,0,0,0,0,0,2,1,0,0,3,-115,Home,6
2023-03-12,VGK,STL,1,2,2,0,5,1,1,1,0,3,-145,Away,6.5
2023-03-12,WPG,TB,1,2,0,0,3,1,1,0,0,2,-190,Home,6
2023-03-12,OTT,CGY,0,1,0,0,1,2,2,1,0,5,-195,Home,6.5
2023-03-12,MIN,ARI,2,2,0,0,4,2,1,1,1,5,-210,Away,5.5
2023-03-12,NSH,ANA,2,0,2,1,5,1,1,2,0,4,-160,Away,6
2023-03-13,BUF,TOR,0,1,3,0,4,0,2,1,0,3,-250,Home,7
2023-03-13,COL,MTL,4,2,2,0,8,1,1,2,0,4,-250,Away,6.5
2023-03-13,DAL,SEA,2,2,1,0,5,1,1,0,0,2,-120,Away,6
2023-03-14,VGK,PHI,1,2,2,0,5,0,1,2,0,3,-190,Away,6
2023-03-14,MTL,PIT,4,0,2,0,6,2,2,0,0,4,-355,Home,6.5
2023-03-14,TB,NJ,1,3,0,0,4,1,0,0,0,1,-130,Home,6.5
2023-03-14,WAS,NYR,1,1,1,0,3,3,1,1,0,5,-190,Home,6
2023-03-14,WPG,CAR,0,1,2,0,3,1,2,2,0,5,-235,Home,6
2023-03-14,DET,NSH,0,0,1,0,1,0,1,1,0,2,-140,Home,6
2023-03-14,BOS,CHI,0,2,1,0,3,1,1,4,0,6,-455,Away,6
2023-03-14,OTT,EDM,2,0,1,0,3,2,3,1,0,6,-210,Home,7
2023-03-14,CGY,ARI,1,1,1,0,3,1,1,1,1,4,-267,Away,6
2023-03-14,DAL,VAN,0,2,0,0,2,2,1,2,0,5,-130,Away,6.5
2023-03-14,CBJ,SJ,1,3,1,1,6,1,2,2,0,5,-145,Home,6.5
2023-03-14,NYI,LA,1,1,0,0,2,0,4,1,0,5,-125,Home,5.5
2023-03-15,BUF,WAS,3,0,1,0,4,1,0,3,1,5,-130,Home,6.5
2023-03-15,COL,TOR,1,0,0,1,2,1,0,0,0,1,-140,Home,6.5
2023-03-15,MIN,STL,1,5,2,0,8,3,1,1,0,5,-130,Away,6
2023-03-15,NYI,ANA,1,2,3,0,6,2,0,1,0,3,-210,Away,5.5
2023-03-16,COL,OTT,2,3,0,0,5,1,1,2,0,4,-120,Away,6.5
2023-03-16,MTL,FLA,3,1,1,0,5,7,2,0,0,9,-350,Home,6.5
2023-03-16,PIT,NYR,0,1,1,0,2,1,1,2,0,4,-140,Home,6.5
2023-03-16,TB,NJ,1,1,1,1,4,0,1,2,0,3,-130,Home,6.5
2023-03-16,BOS,WPG,2,0,1,0,3,0,0,0,0,0,-155,Away,6
2023-03-16,CHI,NSH,1,0,1,0,2,0,0,1,0,1,-250,Home,6
2023-03-16,DAL,EDM,0,0,1,0,1,2,0,2,0,4,-160,Home,6.5
2023-03-16,CGY,VGK,1,2,4,0,7,0,2,0,0,2,-115,Away,6
2023-03-16,VAN,ARI,1,0,1,0,2,1,1,1,0,3,-160,Away,6.5
2023-03-16,CBJ,LA,0,0,1,0,1,0,4,0,0,4,-292,Home,6.5
2023-03-16,SEA,SJ,0,0,1,1,2,0,0,1,0,1,-170,Away,6.5
2023-03-17,BUF,PHI,0,0,2,0,2,1,3,1,0,5,-140,Away,6.5
2023-03-17,CAR,TOR,1,1,0,0,2,3,1,1,0,5,-120,Home,6
2023-03-17,STL,WAS,1,3,1,0,5,0,0,2,0,2,-190,Home,6.5
2023-03-17,CBJ,ANA,2,1,1,0,4,2,1,4,0,7,-115,Home,6.5
2023-03-18,COL,DET,1,2,2,0,5,1,0,0,0,1,-190,Away,6.5
2023-03-18,BOS,MIN,1,2,2,0,5,1,0,1,0,2,-160,Away,5.5
2023-03-18,WPG,NSH,0,0,2,1,3,1,0,1,0,2,-140,Away,5.5
2023-03-18,EDM,SEA,2,2,2,0,6,1,2,1,0,4,-135,Away,7
2023-03-18,CAR,PHI,2,1,1,1,5,0,2,2,0,4,-250,Away,6
2023-03-18,NJ,FLA,0,2,0,0,2,0,0,4,0,4,-125,Home,7
2023-03-18,MTL,TB,1,2,0,0,3,1,1,3,0,5,-345,Home,6.5
2023-03-18,TOR,OTT,1,2,1,1,5,1,1,2,0,4,-135,Away,6.5
2023-03-18,PIT,NYR,0,0,0,0,0,2,4,0,0,6,-145,Home,6.5
2023-03-18,DAL,CGY,3,1,1,1,6,1,3,1,0,5,-135,Home,6
2023-03-18,VAN,LA,1,0,1,1,3,1,1,0,0,2,-190,Home,6.5
2023-03-18,CHI,ARI,1,0,1,0,2,0,1,3,0,4,-145,Home,6
2023-03-18,NYI,SJ,1,2,1,0,4,1,0,0,0,1,-190,Away,6
2023-03-19,BOS,BUF,3,1,3,0,7,0,0,0,0,0,-178,Away,6.5
2023-03-19,WAS,MIN,0,1,2,0,3,2,1,2,0,5,-140,Home,6
2023-03-19,CBJ,VGK,0,1,1,0,2,1,4,2,0,7,-335,Home,6.5
2023-03-19,NJ,TB,0,3,2,0,5,1,1,0,0,2,-120,Home,6.5
2023-03-19,NSH,NYR,0,0,0,0,0,6,1,0,0,7,-250,Home,6
2023-03-19,WPG,STL,0,0,0,0,0,1,1,1,0,3,-140,Away,6.5
2023-03-19,VAN,ANA,1,1,0,0,2,0,0,1,0,1,-130,Away,7
2023-03-20,FLA,DET,2,1,2,0,5,1,0,1,0,2,-205,Away,6.5
2023-03-20,OTT,PIT,1,0,1,0,2,0,0,1,0,1,-175,Home,7
2023-03-20,CHI,COL,0,0,0,0,0,1,2,2,0,5,-420,Home,6
2023-03-20,SJ,EDM,1,3,0,0,4,1,2,1,1,5,-335,Home,7
2023-03-20,CGY,LA,0,1,1,0,2,4,2,2,0,8,0,Even,6
2023-03-21,CAR,NYR,0,0,3,0,3,1,0,1,0,2,-130,Home,6
2023-03-21,CBJ,WAS,1,2,3,1,7,3,2,1,0,6,-240,Home,6.5
2023-03-21,FLA,PHI,1,1,1,0,3,1,4,1,0,6,-160,Away,6.5
2023-03-21,MIN,NJ,0,0,1,1,2,0,0,1,0,1,-178,Home,6
2023-03-21,NSH,BUF,2,4,1,0,7,0,2,1,0,3,-150,Home,6.5
2023-03-21,OTT,BOS,1,0,0,0,1,2,0,0,0,2,-305,Home,6.5
2023-03-21,TB,MTL,0,1,1,0,2,2,1,0,0,3,-250,Away,6.5
2023-03-21,TOR,NYI,1,0,1,0,2,0,3,4,0,7,-120,Away,6
2023-03-21,ARI,WPG,0,1,0,0,1,2,0,0,0,2,-320,Home,6.5
2023-03-21,DET,STL,2,0,0,1,3,2,0,0,0,2,-155,Home,6.5
2023-03-21,SEA,DAL,2,1,1,1,5,1,0,3,0,4,-165,Home,6.5
2023-03-21,CGY,ANA,2,1,2,0,5,0,1,0,0,1,-225,Away,6.5
2023-03-21,VGK,VAN,2,2,0,0,4,0,2,1,0,3,-135,Away,6.5
2023-03-22,PIT,COL,0,3,2,0,5,0,1,1,0,2,-145,Home,6.5
2023-03-22,ARI,EDM,1,1,1,0,3,1,1,1,1,4,-480,Home,7
2023-03-23,MIN,PHI,1,2,1,0,4,1,2,1,1,5,-155,Away,5.5
2023-03-23,CHI,WAS,0,0,1,0,1,2,2,2,0,6,-320,Home,6
2023-03-23,MTL,BOS,1,1,0,0,2,2,1,1,0,4,-455,Home,6.5
2023-03-23,NYR,CAR,0,1,1,0,2,1,0,0,0,1,-145,Home,6
2023-03-23,STL,DET,1,3,0,0,4,2,0,1,0,3,-125,Home,6.5
2023-03-23,TB,OTT,0,1,1,0,2,2,1,4,0,7,-125,Away,6.5
2023-03-23,TOR,FLA,1,3,2,0,6,1,1,0,0,2,-140,Home,7
2023-03-23,SEA,NSH,1,0,0,0,1,0,1,0,1,2,-135,Away,6
2023-03-23,VGK,CGY,2,0,1,0,3,1,0,1,0,2,-140,Home,6.5
2023-03-23,PIT,DAL,0,1,1,0,2,1,0,2,0,3,-160,Home,6.5
2023-03-23,SJ,VAN,1,0,1,0,2,3,1,3,0,7,-170,Home,6.5
2023-03-23,WPG,ANA,1,1,1,0,3,1,0,1,0,2,-320,Away,6
2023-03-24,NJ,BUF,2,0,2,0,4,3,2,0,0,5,-178,Away,7
2023-03-24,NYI,CBJ,1,1,2,0,4,0,4,0,1,5,-220,Away,6.5
2023-03-24,ARI,COL,1,0,0,0,1,1,0,2,0,3,-455,Home,6
2023-03-25,DET,PHI,0,0,0,0,0,0,2,1,0,3,-130,Home,6
2023-03-25,TB,BOS,1,0,0,0,1,1,1,0,0,2,-170,Home,6
2023-03-25,SEA,NSH,2,1,4,0,7,0,1,1,0,2,-130,Away,6
2023-03-25,SJ,CGY,1,2,0,0,3,2,1,2,0,5,-305,Home,6.5
2023-03-25,WPG,LA,0,1,0,0,1,1,1,2,0,4,-120,Home,6
2023-03-25,BUF,NYI,0,0,2,0,2,0,0,0,0,0,-170,Home,6.5
2023-03-25,CHI,MIN,0,0,1,0,1,0,1,2,0,3,-350,Home,6
2023-03-25,NYR,FLA,0,2,2,0,4,2,0,1,0,3,-130,Home,6.5
2023-03-25,CBJ,MTL,2,0,0,0,2,2,4,2,0,8,-160,Home,6.5
2023-03-25,OTT,NJ,1,2,0,0,3,1,2,2,0,5,-205,Home,6.5
2023-03-25,TOR,CAR,0,2,1,0,3,2,0,3,0,5,-145,Home,6
2023-03-25,VAN,DAL,1,2,0,0,3,1,0,0,0,1,-178,Home,6.5
2023-03-25,WAS,PIT,0,0,3,0,3,0,2,2,0,4,-145,Home,6.5
2023-03-25,VGK,EDM,2,0,1,1,4,1,1,1,0,3,-195,Home,7
2023-03-25,STL,ANA,3,2,1,0,6,2,0,1,0,3,-155,Away,6.5
2023-03-26,COL,ARI,0,2,1,1,4,0,0,3,0,3,-320,Away,6.5
2023-03-26,BOS,CAR,1,2,0,1,4,0,1,2,0,3,-155,Home,5.5
2023-03-26,TOR,NSH,1,1,1,0,3,0,0,2,0,2,-195,Away,6.5
2023-03-26,VAN,CHI,0,1,3,0,4,1,0,1,0,2,-170,Away,6.5
2023-03-26,STL,LA,1,3,2,0,6,5,0,2,0,7,-250,Home,6.5
2023-03-27,FLA,OTT,0,1,1,0,2,2,1,2,0,5,-155,Away,7
2023-03-27,MTL,BUF,1,1,1,1,4,1,2,0,0,3,-178,Home,7
2023-03-27,NJ,NYI,0,1,0,0,1,1,1,3,0,5,-125,Away,6
2023-03-27,SEA,MIN,0,0,1,0,1,1,2,2,0,5,-120,Home,6
2023-03-27,COL,ANA,2,2,1,0,5,1,0,0,0,1,-285,Away,6.5
2023-03-27,EDM,ARI,3,1,1,0,5,2,0,2,0,4,-320,Away,7
2023-03-28,CBJ,NYR,2,0,0,0,2,3,1,2,0,6,-430,Home,6.5
2023-03-28,MTL,PHI,0,1,1,0,2,0,1,2,0,3,-145,Home,6.5
2023-03-28,NSH,BOS,0,1,1,0,2,0,0,1,0,1,-320,Home,5.5
2023-03-28,PIT,DET,0,3,1,0,4,3,0,4,0,7,-190,Away,6
2023-03-28,TB,CAR,0,2,2,0,4,0,0,0,0,0,-130,Home,6
2023-03-28,VAN,STL,2,1,2,0,5,2,3,0,1,6,0,Even,6.5
2023-03-28,DAL,CHI,2,1,1,0,4,0,0,1,0,1,-305,Away,5.5
2023-03-28,LA,CGY,1,0,0,0,1,2,0,0,0,2,-135,Home,6
2023-03-28,EDM,VGK,3,3,1,0,7,2,1,1,0,4,-115,Away,7
2023-03-28,WPG,SJ,0,0,0,0,0,1,0,2,0,3,-210,Away,6.5
2023-03-29,FLA,TOR,1,0,1,1,3,0,1,1,0,2,-160,Home,7
2023-03-29,NYI,WAS,0,1,0,1,2,0,1,0,0,1,-120,Away,5.5
2023-03-29,MIN,COL,2,1,1,0,4,1,0,1,0,2,-165,Home,6
2023-03-30,CBJ,BOS,1,0,0,0,1,0,1,0,1,2,-480,Home,6.5
2023-03-30,FLA,MTL,1,2,2,0,5,1,0,1,0,2,-195,Away,7
2023-03-30,NSH,PIT,0,0,0,0,0,0,1,1,0,2,-220,Home,6.5
2023-03-30,NYR,NJ,0,1,0,0,1,2,0,0,0,2,-135,Home,6.5
2023-03-30,PHI,OTT,0,1,3,0,4,1,2,1,1,5,-190,Home,6.5
2023-03-30,WAS,TB,0,1,0,0,1,2,0,3,0,5,-210,Home,6
2023-03-30,CAR,DET,0,2,0,0,2,1,1,1,0,3,-220,Away,6
2023-03-30,STL,CHI,0,3,2,0,5,0,1,2,0,3,-135,Away,6.5
2023-03-30,LA,EDM,0,0,0,0,0,1,0,1,0,2,-190,Home,6.5
2023-03-30,ANA,SEA,0,1,0,0,1,2,0,2,0,4,-400,Home,6.5
2023-03-30,VGK,SJ,1,1,1,0,3,2,1,0,1,4,-178,Away,6.5
2023-03-31,NYR,BUF,0,1,1,0,2,1,1,0,1,3,-155,Away,6.5
2023-03-31,DET,WPG,0,0,2,0,2,3,2,1,0,6,-250,Home,6
2023-03-31,CGY,VAN,0,3,1,1,5,1,3,0,0,4,-155,Away,6.5
2023-03-31,DAL,ARI,1,2,2,0,5,2,0,0,0,2,-240,Away,6
2023-04-01,STL,NSH,0,0,1,0,1,2,2,2,0,6,-135,Home,6
2023-04-01,BOS,PIT,1,1,2,0,4,1,0,2,0,3,-115,Away,6.5
2023-04-01,BUF,PHI,1,4,1,0,6,1,1,1,0,3,-115,Home,6.5
2023-04-01,CAR,MTL,1,2,0,0,3,0,0,0,0,0,-267,Away,6.5
2023-04-01,FLA,CBJ,2,2,3,0,7,0,0,0,0,0,-278,Away,7
2023-04-01,NYI,TB,0,0,0,0,0,1,3,1,0,5,-155,Home,5.5
2023-04-01,TOR,OTT,0,3,0,0,3,0,0,0,0,0,-160,Away,6.5
2023-04-01,NJ,CHI,0,3,3,0,6,0,2,1,0,3,-355,Away,6.5
2023-04-01,DAL,COL,0,1,1,0,2,1,2,2,0,5,-165,Home,6
2023-04-01,ANA,EDM,0,0,0,0,0,1,3,2,0,6,-550,Home,7
2023-04-01,LA,SEA,0,1,2,0,3,0,0,1,0,1,-115,Home,6
2023-04-01,MIN,VGK,1,0,0,0,1,2,1,1,0,4,-115,Home,6
2023-04-01,SJ,ARI,3,1,3,0,7,1,0,1,0,2,-120,Away,6.5
2023-04-02,NYR,WAS,2,1,2,0,5,0,1,1,0,2,-135,Away,6
2023-04-02,BOS,STL,1,2,0,1,4,0,1,2,0,3,-235,Away,6
2023-04-02,NYI,CAR,1,0,0,0,1,0,1,1,0,2,-165,Home,5.5
2023-04-02,OTT,CBJ,3,0,0,0,3,2,0,1,1,4,-195,Away,6.5
2023-04-02,PHI,PIT,0,0,2,0,2,2,1,1,0,4,-260,Home,6.5
2023-04-02,DET,TOR,3,0,2,0,5,1,0,1,0,2,-250,Home,6.5
2023-04-02,NJ,WPG,0,0,1,0,1,2,2,2,0,6,-115,Home,6.5
2023-04-02,ANA,CGY,2,2,0,0,4,0,3,2,0,5,-600,Home,6.5
2023-04-02,LA,VAN,1,1,2,0,4,1,0,0,0,1,-115,Away,6.5
2023-04-03,VGK,MIN,1,1,1,1,4,0,3,0,0,3,-135,Home,5.5
2023-04-03,NSH,DAL,0,0,1,0,1,1,2,2,0,5,-205,Home,6
2023-04-03,ARI,SEA,0,1,0,0,1,2,2,4,0,8,-335,Home,6.5
2023-04-04,BUF,FLA,1,0,0,0,1,1,0,1,0,2,-195,Home,7
2023-04-04,CBJ,TOR,1,0,1,0,2,1,1,2,0,4,-430,Home,6.5
2023-04-04,DET,MTL,2,2,1,0,5,0,0,0,0,0,-120,Away,6.5
2023-04-04,OTT,CAR,0,1,1,0,2,2,0,0,1,3,-278,Home,6
2023-04-04,PIT,NJ,0,0,1,0,1,2,2,1,0,5,-150,Home,6.5
2023-04-04,VGK,NSH,0,2,0,0,2,2,0,0,1,3,-145,Away,6
2023-04-04,PHI,STL,0,0,2,0,2,1,2,1,0,4,-130,Home,6.5
2023-04-04,CHI,CGY,2,0,2,0,4,1,1,1,0,3,-455,Home,6
2023-04-04,SEA,VAN,1,3,1,0,5,2,0,0,0,2,0,Even,6.5
2023-04-04,COL,SJ,2,1,0,1,4,0,1,2,0,3,-250,Away,6.5
2023-04-04,EDM,LA,0,1,2,0,3,0,0,1,0,1,-145,Away,6.5
2023-04-05,CGY,WPG,0,1,2,0,3,1,0,0,0,1,-140,Home,6
2023-04-05,TB,NYR,1,2,0,0,3,3,1,2,0,6,-125,Home,6
2023-04-05,EDM,ANA,0,2,1,0,3,0,0,1,0,1,-355,Away,7
2023-04-06,BUF,DET,3,1,2,1,7,2,2,2,0,6,0,Even,6.5
2023-04-06,CBJ,NJ,0,1,0,0,1,1,3,4,0,8,-420,Home,7
2023-04-06,MIN,PIT,0,0,1,0,1,1,1,2,0,4,-130,Home,6
2023-04-06,OTT,FLA,0,1,1,0,2,2,5,0,0,7,-240,Home,7
2023-04-06,TOR,BOS,0,1,0,0,1,0,0,1,1,2,-150,Home,6
2023-04-06,WAS,MTL,1,0,1,0,2,0,4,2,0,6,-160,Away,6.5
2023-04-06,TB,NYI,0,1,0,0,1,0,4,2,0,6,-165,Home,5.5
2023-04-06,CAR,NSH,0,0,0,0,0,2,0,1,0,3,-210,Away,5.5
2023-04-06,NYR,STL,0,0,2,0,2,0,1,1,1,3,-165,Away,6.5
2023-04-06,PHI,DAL,0,1,0,0,1,1,3,0,0,4,-235,Home,6
2023-04-06,CHI,VAN,0,0,0,0,0,1,1,1,0,3,-240,Home,6.5
2023-04-06,LA,VGK,0,2,0,0,2,4,1,0,0,5,-125,Home,6
2023-04-06,ARI,SEA,0,1,1,0,2,1,2,1,0,4,-320,Home,6.5
2023-04-06,COL,SJ,1,4,1,0,6,1,1,0,0,2,-240,Away,6.5
2023-04-08,CAR,BUF,2,1,0,0,3,1,2,1,0,4,-190,Away,6.5
2023-04-08,PIT,DET,2,1,2,0,5,0,1,0,0,1,-190,Away,6.5
2023-04-08,VGK,DAL,1,0,0,0,1,0,1,0,1,2,-170,Home,5.5
2023-04-08,EDM,SJ,2,2,2,0,6,1,0,0,0,1,-267,Away,6.5
2023-04-08,ANA,ARI,1,1,2,0,4,1,2,1,1,5,-150,Home,6.5
2023-04-08,FLA,WAS,0,2,2,0,4,0,2,0,0,2,-190,Away,7
2023-04-08,MTL,TOR,0,1,0,0,1,2,2,3,0,7,-365,Home,6.5
2023-04-08,NSH,WPG,0,0,0,0,0,0,1,1,0,2,-195,Home,5.5
2023-04-08,NYR,CBJ,2,0,2,0,4,0,0,0,0,0,-305,Away,6.5
2023-04-08,TB,OTT,1,2,1,0,4,2,2,3,0,7,-135,Away,6.5
2023-04-08,PHI,NYI,0,0,0,0,0,1,2,1,0,4,-292,Home,5.5
2023-04-08,NJ,BOS,1,0,0,0,1,2,0,0,0,2,-155,Home,6
2023-04-08,STL,MIN,1,0,2,0,3,2,2,1,0,5,-250,Home,6
2023-04-08,CGY,VAN,0,0,2,0,2,2,0,0,1,3,-170,Away,6.5
2023-04-08,CHI,SEA,1,2,0,0,3,3,2,2,0,7,-365,Home,6
2023-04-08,COL,LA,0,2,2,0,4,0,2,1,0,3,-120,Away,6
2023-04-09,BOS,PHI,1,2,2,0,5,1,1,1,0,3,-225,Away,6
2023-04-09,COL,ANA,1,1,2,1,5,0,2,2,0,4,-345,Away,6.5
2023-04-10,BUF,NYR,1,0,1,1,3,0,2,0,0,2,-220,Home,6.5
2023-04-10,CAR,OTT,0,1,1,0,2,2,0,1,0,3,-190,Away,6.5
2023-04-10,DAL,DET,3,3,0,0,6,0,1,0,0,1,-178,Away,6
2023-04-10,NYI,WAS,0,0,2,0,2,3,0,2,0,5,-195,Away,5.5
2023-04-10,SJ,WPG,1,0,1,0,2,3,0,3,0,6,-365,Home,6.5
2023-04-10,TOR,FLA,0,1,0,1,2,0,0,1,0,1,-150,Home,7
2023-04-10,MIN,CHI,1,0,3,0,4,1,1,0,0,2,-235,Away,6
2023-04-10,NSH,CGY,1,0,1,1,3,0,1,1,0,2,-220,Home,5.5
2023-04-10,SEA,ARI,0,3,1,0,4,1,0,0,0,1,-250,Away,6.5
2023-04-10,VAN,LA,0,0,0,0,0,0,1,2,0,3,-195,Home,6.5
2023-04-11,BUF,NJ,0,1,1,0,2,1,2,3,0,6,-250,Home,7
2023-04-11,CBJ,PHI,2,0,1,0,3,2,1,0,1,4,-210,Home,6.5
2023-04-11,DET,CAR,0,1,0,0,1,2,1,1,0,4,-335,Home,6
2023-04-11,TOR,TB,2,1,1,0,4,1,1,1,0,3,-220,Home,6.5
2023-04-11,WAS,BOS,0,1,1,0,2,0,2,3,0,5,-350,Home,6
2023-04-11,CHI,PIT,0,1,4,0,5,0,0,2,0,2,-550,Home,6.5
2023-04-11,WPG,MIN,2,0,1,0,3,0,0,1,0,1,-120,Home,5.5
2023-04-11,EDM,COL,1,0,0,1,2,1,0,0,0,1,-115,Away,6.5
2023-04-11,SEA,VGK,1,0,0,0,1,1,2,1,0,4,-155,Home,6
2023-04-11,VAN,ANA,2,0,1,0,3,1,1,0,0,2,-160,Away,6.5
2023-04-12,MTL,NYI,1,1,0,0,2,2,1,1,0,4,-385,Home,5.5
2023-04-12,DAL,STL,2,3,0,0,5,2,0,0,0,2,-165,Away,6
2023-04-12,SJ,CGY,1,0,0,0,1,0,1,2,0,3,-250,Home,6.5
2023-04-13,BOS,MTL,2,1,2,0,5,1,2,1,0,4,-345,Away,6.5
2023-04-13,CAR,FLA,1,1,4,0,6,0,0,4,0,4,-115,Home,6.5
2023-04-13,DET,TB,0,0,0,0,0,1,0,4,0,5,-250,Home,6.5
2023-04-13,NJ,WAS,1,1,2,1,5,3,1,0,0,4,-145,Away,6.5
2023-04-13,OTT,BUF,0,3,0,0,3,0,2,1,1,4,-135,Home,7
2023-04-13,PIT,CBJ,1,0,1,0,2,0,1,1,1,3,-250,Away,6.5
2023-04-13,TOR,NYR,0,0,3,0,3,0,1,1,0,2,-140,Home,6.5
2023-04-13,MIN,NSH,1,1,1,0,3,2,0,1,1,4,-160,Home,5
2023-04-13,STL,DAL,0,0,0,0,0,0,0,1,0,1,-305,Home,6
2023-04-13,WPG,COL,0,2,0,0,2,1,1,2,0,4,-320,Home,6
2023-04-13,PHI,CHI,2,2,0,1,5,2,1,1,0,4,-115,Away,6
2023-04-13,SJ,EDM,1,1,0,0,2,2,2,1,0,5,-550,Home,7
2023-04-13,LA,ANA,1,2,2,0,5,1,0,2,0,3,-267,Away,6.5
2023-04-13,VAN,ARI,4,0,0,1,5,2,1,1,0,4,-155,Away,6.5
2023-04-13,VGK,SEA,1,1,1,0,3,1,0,0,0,1,0,Even,6